"","DE","Normalisation","Threshold","Go_BP","Go_MF","Go_CC","Total","DEs"
"638","T","MedI-G",0.04,29,0,1,30,26
"639","T","MedI-G",0.05,24,0,0,24,29
"636","T","MedI-G",0.02,21,0,0,21,16
"637","T","MedI-G",0.03,21,0,0,21,16
"640","T","MedI-G",0.06,11,0,0,11,40
"642","T","MedI-G",0.08,10,0,1,11,52
"225","QM","TI-G",0.05,0,2,7,9,28
"226","QM","TI-G",0.06,0,2,7,9,28
"227","QM","TI-G",0.07,0,2,7,9,28
"228","QM","TI-G",0.08,0,2,7,9,28
"229","QM","TI-G",0.09,0,1,7,8,30
"230","QM","TI-G",0.1,0,1,7,8,30
"643","T","MedI-G",0.09,7,0,1,8,54
"266","QM","MedI-G",0.009,0,0,7,7,31
"316","QM","AI-G",0.04,0,2,5,7,27
"317","QM","AI-G",0.05,0,0,7,7,29
"224","QM","TI-G",0.04,0,2,4,6,27
"641","T","MedI-G",0.07,6,0,0,6,49
"644","T","MedI-G",0.1,6,0,0,6,58
"103","QM","RLR-G",2e-05,5,0,0,5,49
"221","QM","TI-G",0.01,0,2,3,5,20
"308","QM","AI-G",0.005,0,2,3,5,20
"309","QM","AI-G",0.006,0,2,3,5,20
"310","QM","AI-G",0.007,0,2,3,5,20
"633","T","MedI-G",0.008,0,0,5,5,8
"634","T","MedI-G",0.009,0,0,5,5,8
"635","T","MedI-G",0.01,0,0,5,5,8
"104","QM","RLR-G",3e-05,0,3,0,3,51
"130","QM","RLR-G",0.02,3,0,0,3,84
"131","QM","RLR-G",0.03,3,0,0,3,84
"132","QM","RLR-G",0.04,3,0,0,3,85
"133","QM","RLR-G",0.05,3,0,0,3,87
"134","QM","RLR-G",0.06,3,0,0,3,89
"135","QM","RLR-G",0.07,3,0,0,3,90
"136","QM","RLR-G",0.08,3,0,0,3,90
"137","QM","RLR-G",0.09,3,0,0,3,91
"138","QM","RLR-G",0.1,3,0,0,3,92
"176","QM","VSN-G",0.02,0,2,1,3,26
"177","QM","VSN-G",0.03,0,2,1,3,30
"305","QM","AI-G",0.002,0,3,0,3,17
"367","QM","Quantile",0.09,3,0,0,3,55
"95","QM","RLR-G",3e-06,1,0,1,2,39
"222","QM","TI-G",0.02,0,2,0,2,25
"223","QM","TI-G",0.03,0,2,0,2,25
"311","QM","AI-G",0.008,0,2,0,2,23
"312","QM","AI-G",0.009,0,2,0,2,23
"313","QM","AI-G",0.01,0,2,0,2,23
"314","QM","AI-G",0.02,0,2,0,2,26
"315","QM","AI-G",0.03,0,2,0,2,26
"366","QM","Quantile",0.08,2,0,0,2,51
"368","QM","Quantile",0.1,2,0,0,2,59
"85","QM","Loess-G",0.03,0,0,1,1,28
"94","QM","RLR-G",2e-06,0,0,1,1,37
"96","QM","RLR-G",4e-06,0,0,1,1,41
"97","QM","RLR-G",5e-06,0,0,1,1,42
"105","QM","RLR-G",4e-05,0,0,1,1,53
"106","QM","RLR-G",5e-05,0,0,1,1,54
"108","QM","RLR-G",7e-05,0,0,1,1,57
"109","QM","RLR-G",8e-05,0,0,1,1,58
"110","QM","RLR-G",9e-05,0,0,1,1,58
"111","QM","RLR-G",1e-04,0,0,1,1,58
"112","QM","RLR-G",2e-04,0,0,1,1,58
"113","QM","RLR-G",3e-04,0,0,1,1,61
"114","QM","RLR-G",4e-04,0,0,1,1,62
"115","QM","RLR-G",5e-04,0,0,1,1,63
"116","QM","RLR-G",6e-04,0,0,1,1,64
"117","QM","RLR-G",7e-04,0,0,1,1,65
"118","QM","RLR-G",8e-04,0,0,1,1,65
"119","QM","RLR-G",9e-04,0,0,1,1,65
"120","QM","RLR-G",0.001,0,0,1,1,67
"121","QM","RLR-G",0.002,0,0,1,1,68
"156","QM","VSN-G",9e-05,0,1,0,1,9
"157","QM","VSN-G",1e-04,0,1,0,1,9
"158","QM","VSN-G",2e-04,0,1,0,1,11
"159","QM","VSN-G",3e-04,0,1,0,1,11
"175","QM","VSN-G",0.01,0,1,0,1,24
"178","QM","VSN-G",0.04,0,1,0,1,32
"179","QM","VSN-G",0.05,0,1,0,1,35
"180","QM","VSN-G",0.06,0,1,0,1,38
"181","QM","VSN-G",0.07,0,1,0,1,44
"182","QM","VSN-G",0.08,0,1,0,1,45
"203","QM","TI-G",1e-04,0,1,0,1,12
"204","QM","TI-G",2e-04,0,1,0,1,12
"205","QM","TI-G",3e-04,0,1,0,1,12
"206","QM","TI-G",4e-04,0,1,0,1,12
"207","QM","TI-G",5e-04,0,1,0,1,12
"217","QM","TI-G",0.006,0,1,0,1,18
"218","QM","TI-G",0.007,0,1,0,1,18
"219","QM","TI-G",0.008,0,1,0,1,18
"220","QM","TI-G",0.009,0,1,0,1,18
"289","QM","AI-G",4e-05,0,1,0,1,11
"290","QM","AI-G",5e-05,0,1,0,1,11
"291","QM","AI-G",6e-05,0,1,0,1,12
"292","QM","AI-G",7e-05,0,1,0,1,12
"293","QM","AI-G",8e-05,0,1,0,1,12
"294","QM","AI-G",9e-05,0,1,0,1,12
"295","QM","AI-G",1e-04,0,1,0,1,12
"296","QM","AI-G",2e-04,0,1,0,1,12
"306","QM","AI-G",0.003,0,1,0,1,18
"307","QM","AI-G",0.004,0,1,0,1,18
"318","QM","AI-G",0.06,0,1,0,1,32
"498","T","RLR-G",0.02,0,1,0,1,19
"499","T","RLR-G",0.03,0,1,0,1,22
"549","T","VSN-G",0.07,0,0,1,1,29
"550","T","VSN-G",0.08,1,0,0,1,37
"552","T","VSN-G",0.1,1,0,0,1,44
"1","QM","None",1e-06,0,0,0,0,0
"2","QM","None",2e-06,0,0,0,0,0
"3","QM","None",3e-06,0,0,0,0,0
"4","QM","None",4e-06,0,0,0,0,0
"5","QM","None",5e-06,0,0,0,0,0
"6","QM","None",6e-06,0,0,0,0,0
"7","QM","None",7e-06,0,0,0,0,0
"8","QM","None",8e-06,0,0,0,0,0
"9","QM","None",9e-06,0,0,0,0,0
"10","QM","None",1e-05,0,0,0,0,0
"11","QM","None",2e-05,0,0,0,0,1
"12","QM","None",3e-05,0,0,0,0,1
"13","QM","None",4e-05,0,0,0,0,1
"14","QM","None",5e-05,0,0,0,0,1
"15","QM","None",6e-05,0,0,0,0,1
"16","QM","None",7e-05,0,0,0,0,1
"17","QM","None",8e-05,0,0,0,0,1
"18","QM","None",9e-05,0,0,0,0,1
"19","QM","None",1e-04,0,0,0,0,1
"20","QM","None",2e-04,0,0,0,0,1
"21","QM","None",3e-04,0,0,0,0,1
"22","QM","None",4e-04,0,0,0,0,1
"23","QM","None",5e-04,0,0,0,0,1
"24","QM","None",6e-04,0,0,0,0,1
"25","QM","None",7e-04,0,0,0,0,1
"26","QM","None",8e-04,0,0,0,0,1
"27","QM","None",9e-04,0,0,0,0,1
"28","QM","None",0.001,0,0,0,0,2
"29","QM","None",0.002,0,0,0,0,3
"30","QM","None",0.003,0,0,0,0,3
"31","QM","None",0.004,0,0,0,0,5
"32","QM","None",0.005,0,0,0,0,5
"33","QM","None",0.006,0,0,0,0,5
"34","QM","None",0.007,0,0,0,0,5
"35","QM","None",0.008,0,0,0,0,6
"36","QM","None",0.009,0,0,0,0,6
"37","QM","None",0.01,0,0,0,0,6
"38","QM","None",0.02,0,0,0,0,11
"39","QM","None",0.03,0,0,0,0,14
"40","QM","None",0.04,0,0,0,0,17
"41","QM","None",0.05,0,0,0,0,18
"42","QM","None",0.06,0,0,0,0,23
"43","QM","None",0.07,0,0,0,0,24
"44","QM","None",0.08,0,0,0,0,25
"45","QM","None",0.09,0,0,0,0,28
"46","QM","None",0.1,0,0,0,0,30
"47","QM","Loess-G",1e-06,0,0,0,0,0
"48","QM","Loess-G",2e-06,0,0,0,0,0
"49","QM","Loess-G",3e-06,0,0,0,0,1
"50","QM","Loess-G",4e-06,0,0,0,0,1
"51","QM","Loess-G",5e-06,0,0,0,0,1
"52","QM","Loess-G",6e-06,0,0,0,0,1
"53","QM","Loess-G",7e-06,0,0,0,0,1
"54","QM","Loess-G",8e-06,0,0,0,0,1
"55","QM","Loess-G",9e-06,0,0,0,0,1
"56","QM","Loess-G",1e-05,0,0,0,0,1
"57","QM","Loess-G",2e-05,0,0,0,0,1
"58","QM","Loess-G",3e-05,0,0,0,0,1
"59","QM","Loess-G",4e-05,0,0,0,0,1
"60","QM","Loess-G",5e-05,0,0,0,0,1
"61","QM","Loess-G",6e-05,0,0,0,0,1
"62","QM","Loess-G",7e-05,0,0,0,0,1
"63","QM","Loess-G",8e-05,0,0,0,0,1
"64","QM","Loess-G",9e-05,0,0,0,0,1
"65","QM","Loess-G",1e-04,0,0,0,0,1
"66","QM","Loess-G",2e-04,0,0,0,0,3
"67","QM","Loess-G",3e-04,0,0,0,0,4
"68","QM","Loess-G",4e-04,0,0,0,0,5
"69","QM","Loess-G",5e-04,0,0,0,0,5
"70","QM","Loess-G",6e-04,0,0,0,0,6
"71","QM","Loess-G",7e-04,0,0,0,0,9
"72","QM","Loess-G",8e-04,0,0,0,0,9
"73","QM","Loess-G",9e-04,0,0,0,0,9
"74","QM","Loess-G",0.001,0,0,0,0,9
"75","QM","Loess-G",0.002,0,0,0,0,10
"76","QM","Loess-G",0.003,0,0,0,0,12
"77","QM","Loess-G",0.004,0,0,0,0,15
"78","QM","Loess-G",0.005,0,0,0,0,16
"79","QM","Loess-G",0.006,0,0,0,0,16
"80","QM","Loess-G",0.007,0,0,0,0,17
"81","QM","Loess-G",0.008,0,0,0,0,18
"82","QM","Loess-G",0.009,0,0,0,0,19
"83","QM","Loess-G",0.01,0,0,0,0,19
"84","QM","Loess-G",0.02,0,0,0,0,23
"86","QM","Loess-G",0.04,0,0,0,0,33
"87","QM","Loess-G",0.05,0,0,0,0,37
"88","QM","Loess-G",0.06,0,0,0,0,38
"89","QM","Loess-G",0.07,0,0,0,0,44
"90","QM","Loess-G",0.08,0,0,0,0,48
"91","QM","Loess-G",0.09,0,0,0,0,49
"92","QM","Loess-G",0.1,0,0,0,0,51
"93","QM","RLR-G",1e-06,0,0,0,0,34
"98","QM","RLR-G",6e-06,0,0,0,0,43
"99","QM","RLR-G",7e-06,0,0,0,0,43
"100","QM","RLR-G",8e-06,0,0,0,0,43
"101","QM","RLR-G",9e-06,0,0,0,0,45
"102","QM","RLR-G",1e-05,0,0,0,0,46
"107","QM","RLR-G",6e-05,0,0,0,0,56
"122","QM","RLR-G",0.003,0,0,0,0,74
"123","QM","RLR-G",0.004,0,0,0,0,74
"124","QM","RLR-G",0.005,0,0,0,0,76
"125","QM","RLR-G",0.006,0,0,0,0,78
"126","QM","RLR-G",0.007,0,0,0,0,78
"127","QM","RLR-G",0.008,0,0,0,0,78
"128","QM","RLR-G",0.009,0,0,0,0,79
"129","QM","RLR-G",0.01,0,0,0,0,79
"139","QM","VSN-G",1e-06,0,0,0,0,3
"140","QM","VSN-G",2e-06,0,0,0,0,3
"141","QM","VSN-G",3e-06,0,0,0,0,3
"142","QM","VSN-G",4e-06,0,0,0,0,3
"143","QM","VSN-G",5e-06,0,0,0,0,4
"144","QM","VSN-G",6e-06,0,0,0,0,4
"145","QM","VSN-G",7e-06,0,0,0,0,4
"146","QM","VSN-G",8e-06,0,0,0,0,4
"147","QM","VSN-G",9e-06,0,0,0,0,4
"148","QM","VSN-G",1e-05,0,0,0,0,4
"149","QM","VSN-G",2e-05,0,0,0,0,5
"150","QM","VSN-G",3e-05,0,0,0,0,5
"151","QM","VSN-G",4e-05,0,0,0,0,5
"152","QM","VSN-G",5e-05,0,0,0,0,7
"153","QM","VSN-G",6e-05,0,0,0,0,7
"154","QM","VSN-G",7e-05,0,0,0,0,7
"155","QM","VSN-G",8e-05,0,0,0,0,7
"160","QM","VSN-G",4e-04,0,0,0,0,12
"161","QM","VSN-G",5e-04,0,0,0,0,12
"162","QM","VSN-G",6e-04,0,0,0,0,12
"163","QM","VSN-G",7e-04,0,0,0,0,12
"164","QM","VSN-G",8e-04,0,0,0,0,12
"165","QM","VSN-G",9e-04,0,0,0,0,12
"166","QM","VSN-G",0.001,0,0,0,0,13
"167","QM","VSN-G",0.002,0,0,0,0,16
"168","QM","VSN-G",0.003,0,0,0,0,17
"169","QM","VSN-G",0.004,0,0,0,0,19
"170","QM","VSN-G",0.005,0,0,0,0,20
"171","QM","VSN-G",0.006,0,0,0,0,20
"172","QM","VSN-G",0.007,0,0,0,0,23
"173","QM","VSN-G",0.008,0,0,0,0,23
"174","QM","VSN-G",0.009,0,0,0,0,23
"183","QM","VSN-G",0.09,0,0,0,0,48
"184","QM","VSN-G",0.1,0,0,0,0,50
"185","QM","TI-G",1e-06,0,0,0,0,5
"186","QM","TI-G",2e-06,0,0,0,0,6
"187","QM","TI-G",3e-06,0,0,0,0,7
"188","QM","TI-G",4e-06,0,0,0,0,8
"189","QM","TI-G",5e-06,0,0,0,0,8
"190","QM","TI-G",6e-06,0,0,0,0,8
"191","QM","TI-G",7e-06,0,0,0,0,8
"192","QM","TI-G",8e-06,0,0,0,0,8
"193","QM","TI-G",9e-06,0,0,0,0,9
"194","QM","TI-G",1e-05,0,0,0,0,9
"195","QM","TI-G",2e-05,0,0,0,0,9
"196","QM","TI-G",3e-05,0,0,0,0,9
"197","QM","TI-G",4e-05,0,0,0,0,9
"198","QM","TI-G",5e-05,0,0,0,0,9
"199","QM","TI-G",6e-05,0,0,0,0,10
"200","QM","TI-G",7e-05,0,0,0,0,10
"201","QM","TI-G",8e-05,0,0,0,0,11
"202","QM","TI-G",9e-05,0,0,0,0,11
"208","QM","TI-G",6e-04,0,0,0,0,13
"209","QM","TI-G",7e-04,0,0,0,0,13
"210","QM","TI-G",8e-04,0,0,0,0,13
"211","QM","TI-G",9e-04,0,0,0,0,13
"212","QM","TI-G",0.001,0,0,0,0,13
"213","QM","TI-G",0.002,0,0,0,0,15
"214","QM","TI-G",0.003,0,0,0,0,16
"215","QM","TI-G",0.004,0,0,0,0,17
"216","QM","TI-G",0.005,0,0,0,0,17
"231","QM","MedI-G",1e-06,0,0,0,0,8
"232","QM","MedI-G",2e-06,0,0,0,0,9
"233","QM","MedI-G",3e-06,0,0,0,0,9
"234","QM","MedI-G",4e-06,0,0,0,0,9
"235","QM","MedI-G",5e-06,0,0,0,0,9
"236","QM","MedI-G",6e-06,0,0,0,0,10
"237","QM","MedI-G",7e-06,0,0,0,0,11
"238","QM","MedI-G",8e-06,0,0,0,0,11
"239","QM","MedI-G",9e-06,0,0,0,0,11
"240","QM","MedI-G",1e-05,0,0,0,0,12
"241","QM","MedI-G",2e-05,0,0,0,0,13
"242","QM","MedI-G",3e-05,0,0,0,0,15
"243","QM","MedI-G",4e-05,0,0,0,0,15
"244","QM","MedI-G",5e-05,0,0,0,0,15
"245","QM","MedI-G",6e-05,0,0,0,0,17
"246","QM","MedI-G",7e-05,0,0,0,0,17
"247","QM","MedI-G",8e-05,0,0,0,0,17
"248","QM","MedI-G",9e-05,0,0,0,0,17
"249","QM","MedI-G",1e-04,0,0,0,0,17
"250","QM","MedI-G",2e-04,0,0,0,0,19
"251","QM","MedI-G",3e-04,0,0,0,0,19
"252","QM","MedI-G",4e-04,0,0,0,0,22
"253","QM","MedI-G",5e-04,0,0,0,0,22
"254","QM","MedI-G",6e-04,0,0,0,0,22
"255","QM","MedI-G",7e-04,0,0,0,0,22
"256","QM","MedI-G",8e-04,0,0,0,0,23
"257","QM","MedI-G",9e-04,0,0,0,0,23
"258","QM","MedI-G",0.001,0,0,0,0,23
"259","QM","MedI-G",0.002,0,0,0,0,25
"260","QM","MedI-G",0.003,0,0,0,0,25
"261","QM","MedI-G",0.004,0,0,0,0,27
"262","QM","MedI-G",0.005,0,0,0,0,27
"263","QM","MedI-G",0.006,0,0,0,0,29
"264","QM","MedI-G",0.007,0,0,0,0,30
"265","QM","MedI-G",0.008,0,0,0,0,30
"267","QM","MedI-G",0.01,0,0,0,0,32
"268","QM","MedI-G",0.02,0,0,0,0,34
"269","QM","MedI-G",0.03,0,0,0,0,34
"270","QM","MedI-G",0.04,0,0,0,0,34
"271","QM","MedI-G",0.05,0,0,0,0,35
"272","QM","MedI-G",0.06,0,0,0,0,35
"273","QM","MedI-G",0.07,0,0,0,0,35
"274","QM","MedI-G",0.08,0,0,0,0,38
"275","QM","MedI-G",0.09,0,0,0,0,38
"276","QM","MedI-G",0.1,0,0,0,0,38
"277","QM","AI-G",1e-06,0,0,0,0,9
"278","QM","AI-G",2e-06,0,0,0,0,9
"279","QM","AI-G",3e-06,0,0,0,0,9
"280","QM","AI-G",4e-06,0,0,0,0,9
"281","QM","AI-G",5e-06,0,0,0,0,9
"282","QM","AI-G",6e-06,0,0,0,0,9
"283","QM","AI-G",7e-06,0,0,0,0,9
"284","QM","AI-G",8e-06,0,0,0,0,9
"285","QM","AI-G",9e-06,0,0,0,0,9
"286","QM","AI-G",1e-05,0,0,0,0,9
"287","QM","AI-G",2e-05,0,0,0,0,10
"288","QM","AI-G",3e-05,0,0,0,0,10
"297","QM","AI-G",3e-04,0,0,0,0,14
"298","QM","AI-G",4e-04,0,0,0,0,14
"299","QM","AI-G",5e-04,0,0,0,0,14
"300","QM","AI-G",6e-04,0,0,0,0,15
"301","QM","AI-G",7e-04,0,0,0,0,16
"302","QM","AI-G",8e-04,0,0,0,0,16
"303","QM","AI-G",9e-04,0,0,0,0,16
"304","QM","AI-G",0.001,0,0,0,0,16
"319","QM","AI-G",0.07,0,0,0,0,33
"320","QM","AI-G",0.08,0,0,0,0,34
"321","QM","AI-G",0.09,0,0,0,0,34
"322","QM","AI-G",0.1,0,0,0,0,34
"323","QM","Quantile",1e-06,0,0,0,0,0
"324","QM","Quantile",2e-06,0,0,0,0,0
"325","QM","Quantile",3e-06,0,0,0,0,2
"326","QM","Quantile",4e-06,0,0,0,0,3
"327","QM","Quantile",5e-06,0,0,0,0,3
"328","QM","Quantile",6e-06,0,0,0,0,3
"329","QM","Quantile",7e-06,0,0,0,0,3
"330","QM","Quantile",8e-06,0,0,0,0,3
"331","QM","Quantile",9e-06,0,0,0,0,3
"332","QM","Quantile",1e-05,0,0,0,0,3
"333","QM","Quantile",2e-05,0,0,0,0,3
"334","QM","Quantile",3e-05,0,0,0,0,4
"335","QM","Quantile",4e-05,0,0,0,0,4
"336","QM","Quantile",5e-05,0,0,0,0,4
"337","QM","Quantile",6e-05,0,0,0,0,4
"338","QM","Quantile",7e-05,0,0,0,0,4
"339","QM","Quantile",8e-05,0,0,0,0,4
"340","QM","Quantile",9e-05,0,0,0,0,4
"341","QM","Quantile",1e-04,0,0,0,0,4
"342","QM","Quantile",2e-04,0,0,0,0,5
"343","QM","Quantile",3e-04,0,0,0,0,5
"344","QM","Quantile",4e-04,0,0,0,0,6
"345","QM","Quantile",5e-04,0,0,0,0,6
"346","QM","Quantile",6e-04,0,0,0,0,7
"347","QM","Quantile",7e-04,0,0,0,0,8
"348","QM","Quantile",8e-04,0,0,0,0,8
"349","QM","Quantile",9e-04,0,0,0,0,9
"350","QM","Quantile",0.001,0,0,0,0,9
"351","QM","Quantile",0.002,0,0,0,0,14
"352","QM","Quantile",0.003,0,0,0,0,17
"353","QM","Quantile",0.004,0,0,0,0,19
"354","QM","Quantile",0.005,0,0,0,0,20
"355","QM","Quantile",0.006,0,0,0,0,24
"356","QM","Quantile",0.007,0,0,0,0,24
"357","QM","Quantile",0.008,0,0,0,0,26
"358","QM","Quantile",0.009,0,0,0,0,27
"359","QM","Quantile",0.01,0,0,0,0,27
"360","QM","Quantile",0.02,0,0,0,0,33
"361","QM","Quantile",0.03,0,0,0,0,40
"362","QM","Quantile",0.04,0,0,0,0,41
"363","QM","Quantile",0.05,0,0,0,0,46
"364","QM","Quantile",0.06,0,0,0,0,47
"365","QM","Quantile",0.07,0,0,0,0,48
"369","T","None",1e-06,0,0,0,0,0
"370","T","None",2e-06,0,0,0,0,0
"371","T","None",3e-06,0,0,0,0,0
"372","T","None",4e-06,0,0,0,0,0
"373","T","None",5e-06,0,0,0,0,0
"374","T","None",6e-06,0,0,0,0,0
"375","T","None",7e-06,0,0,0,0,0
"376","T","None",8e-06,0,0,0,0,0
"377","T","None",9e-06,0,0,0,0,0
"378","T","None",1e-05,0,0,0,0,0
"379","T","None",2e-05,0,0,0,0,0
"380","T","None",3e-05,0,0,0,0,0
"381","T","None",4e-05,0,0,0,0,0
"382","T","None",5e-05,0,0,0,0,0
"383","T","None",6e-05,0,0,0,0,0
"384","T","None",7e-05,0,0,0,0,0
"385","T","None",8e-05,0,0,0,0,0
"386","T","None",9e-05,0,0,0,0,0
"387","T","None",1e-04,0,0,0,0,0
"388","T","None",2e-04,0,0,0,0,0
"389","T","None",3e-04,0,0,0,0,0
"390","T","None",4e-04,0,0,0,0,0
"391","T","None",5e-04,0,0,0,0,0
"392","T","None",6e-04,0,0,0,0,0
"393","T","None",7e-04,0,0,0,0,0
"394","T","None",8e-04,0,0,0,0,0
"395","T","None",9e-04,0,0,0,0,0
"396","T","None",0.001,0,0,0,0,0
"397","T","None",0.002,0,0,0,0,0
"398","T","None",0.003,0,0,0,0,1
"399","T","None",0.004,0,0,0,0,1
"400","T","None",0.005,0,0,0,0,1
"401","T","None",0.006,0,0,0,0,1
"402","T","None",0.007,0,0,0,0,1
"403","T","None",0.008,0,0,0,0,1
"404","T","None",0.009,0,0,0,0,1
"405","T","None",0.01,0,0,0,0,6
"406","T","None",0.02,0,0,0,0,9
"407","T","None",0.03,0,0,0,0,15
"408","T","None",0.04,0,0,0,0,16
"409","T","None",0.05,0,0,0,0,18
"410","T","None",0.06,0,0,0,0,19
"411","T","None",0.07,0,0,0,0,27
"412","T","None",0.08,0,0,0,0,28
"413","T","None",0.09,0,0,0,0,30
"414","T","None",0.1,0,0,0,0,30
"415","T","Loess-G",1e-06,0,0,0,0,0
"416","T","Loess-G",2e-06,0,0,0,0,0
"417","T","Loess-G",3e-06,0,0,0,0,0
"418","T","Loess-G",4e-06,0,0,0,0,0
"419","T","Loess-G",5e-06,0,0,0,0,0
"420","T","Loess-G",6e-06,0,0,0,0,0
"421","T","Loess-G",7e-06,0,0,0,0,0
"422","T","Loess-G",8e-06,0,0,0,0,0
"423","T","Loess-G",9e-06,0,0,0,0,0
"424","T","Loess-G",1e-05,0,0,0,0,0
"425","T","Loess-G",2e-05,0,0,0,0,0
"426","T","Loess-G",3e-05,0,0,0,0,0
"427","T","Loess-G",4e-05,0,0,0,0,0
"428","T","Loess-G",5e-05,0,0,0,0,0
"429","T","Loess-G",6e-05,0,0,0,0,0
"430","T","Loess-G",7e-05,0,0,0,0,0
"431","T","Loess-G",8e-05,0,0,0,0,0
"432","T","Loess-G",9e-05,0,0,0,0,0
"433","T","Loess-G",1e-04,0,0,0,0,0
"434","T","Loess-G",2e-04,0,0,0,0,0
"435","T","Loess-G",3e-04,0,0,0,0,0
"436","T","Loess-G",4e-04,0,0,0,0,0
"437","T","Loess-G",5e-04,0,0,0,0,0
"438","T","Loess-G",6e-04,0,0,0,0,0
"439","T","Loess-G",7e-04,0,0,0,0,0
"440","T","Loess-G",8e-04,0,0,0,0,0
"441","T","Loess-G",9e-04,0,0,0,0,0
"442","T","Loess-G",0.001,0,0,0,0,0
"443","T","Loess-G",0.002,0,0,0,0,0
"444","T","Loess-G",0.003,0,0,0,0,0
"445","T","Loess-G",0.004,0,0,0,0,3
"446","T","Loess-G",0.005,0,0,0,0,4
"447","T","Loess-G",0.006,0,0,0,0,6
"448","T","Loess-G",0.007,0,0,0,0,7
"449","T","Loess-G",0.008,0,0,0,0,7
"450","T","Loess-G",0.009,0,0,0,0,7
"451","T","Loess-G",0.01,0,0,0,0,7
"452","T","Loess-G",0.02,0,0,0,0,10
"453","T","Loess-G",0.03,0,0,0,0,14
"454","T","Loess-G",0.04,0,0,0,0,16
"455","T","Loess-G",0.05,0,0,0,0,22
"456","T","Loess-G",0.06,0,0,0,0,22
"457","T","Loess-G",0.07,0,0,0,0,27
"458","T","Loess-G",0.08,0,0,0,0,34
"459","T","Loess-G",0.09,0,0,0,0,37
"460","T","Loess-G",0.1,0,0,0,0,39
"461","T","RLR-G",1e-06,0,0,0,0,0
"462","T","RLR-G",2e-06,0,0,0,0,0
"463","T","RLR-G",3e-06,0,0,0,0,0
"464","T","RLR-G",4e-06,0,0,0,0,0
"465","T","RLR-G",5e-06,0,0,0,0,0
"466","T","RLR-G",6e-06,0,0,0,0,0
"467","T","RLR-G",7e-06,0,0,0,0,0
"468","T","RLR-G",8e-06,0,0,0,0,0
"469","T","RLR-G",9e-06,0,0,0,0,0
"470","T","RLR-G",1e-05,0,0,0,0,0
"471","T","RLR-G",2e-05,0,0,0,0,0
"472","T","RLR-G",3e-05,0,0,0,0,0
"473","T","RLR-G",4e-05,0,0,0,0,0
"474","T","RLR-G",5e-05,0,0,0,0,0
"475","T","RLR-G",6e-05,0,0,0,0,0
"476","T","RLR-G",7e-05,0,0,0,0,0
"477","T","RLR-G",8e-05,0,0,0,0,0
"478","T","RLR-G",9e-05,0,0,0,0,0
"479","T","RLR-G",1e-04,0,0,0,0,0
"480","T","RLR-G",2e-04,0,0,0,0,0
"481","T","RLR-G",3e-04,0,0,0,0,0
"482","T","RLR-G",4e-04,0,0,0,0,0
"483","T","RLR-G",5e-04,0,0,0,0,0
"484","T","RLR-G",6e-04,0,0,0,0,0
"485","T","RLR-G",7e-04,0,0,0,0,0
"486","T","RLR-G",8e-04,0,0,0,0,0
"487","T","RLR-G",9e-04,0,0,0,0,0
"488","T","RLR-G",0.001,0,0,0,0,1
"489","T","RLR-G",0.002,0,0,0,0,1
"490","T","RLR-G",0.003,0,0,0,0,3
"491","T","RLR-G",0.004,0,0,0,0,4
"492","T","RLR-G",0.005,0,0,0,0,9
"493","T","RLR-G",0.006,0,0,0,0,9
"494","T","RLR-G",0.007,0,0,0,0,9
"495","T","RLR-G",0.008,0,0,0,0,9
"496","T","RLR-G",0.009,0,0,0,0,9
"497","T","RLR-G",0.01,0,0,0,0,9
"500","T","RLR-G",0.04,0,0,0,0,24
"501","T","RLR-G",0.05,0,0,0,0,39
"502","T","RLR-G",0.06,0,0,0,0,41
"503","T","RLR-G",0.07,0,0,0,0,45
"504","T","RLR-G",0.08,0,0,0,0,46
"505","T","RLR-G",0.09,0,0,0,0,57
"506","T","RLR-G",0.1,0,0,0,0,65
"507","T","VSN-G",1e-06,0,0,0,0,0
"508","T","VSN-G",2e-06,0,0,0,0,0
"509","T","VSN-G",3e-06,0,0,0,0,0
"510","T","VSN-G",4e-06,0,0,0,0,0
"511","T","VSN-G",5e-06,0,0,0,0,0
"512","T","VSN-G",6e-06,0,0,0,0,0
"513","T","VSN-G",7e-06,0,0,0,0,0
"514","T","VSN-G",8e-06,0,0,0,0,0
"515","T","VSN-G",9e-06,0,0,0,0,0
"516","T","VSN-G",1e-05,0,0,0,0,0
"517","T","VSN-G",2e-05,0,0,0,0,0
"518","T","VSN-G",3e-05,0,0,0,0,0
"519","T","VSN-G",4e-05,0,0,0,0,0
"520","T","VSN-G",5e-05,0,0,0,0,0
"521","T","VSN-G",6e-05,0,0,0,0,0
"522","T","VSN-G",7e-05,0,0,0,0,0
"523","T","VSN-G",8e-05,0,0,0,0,0
"524","T","VSN-G",9e-05,0,0,0,0,0
"525","T","VSN-G",1e-04,0,0,0,0,0
"526","T","VSN-G",2e-04,0,0,0,0,0
"527","T","VSN-G",3e-04,0,0,0,0,0
"528","T","VSN-G",4e-04,0,0,0,0,0
"529","T","VSN-G",5e-04,0,0,0,0,0
"530","T","VSN-G",6e-04,0,0,0,0,0
"531","T","VSN-G",7e-04,0,0,0,0,0
"532","T","VSN-G",8e-04,0,0,0,0,0
"533","T","VSN-G",9e-04,0,0,0,0,0
"534","T","VSN-G",0.001,0,0,0,0,0
"535","T","VSN-G",0.002,0,0,0,0,0
"536","T","VSN-G",0.003,0,0,0,0,0
"537","T","VSN-G",0.004,0,0,0,0,0
"538","T","VSN-G",0.005,0,0,0,0,0
"539","T","VSN-G",0.006,0,0,0,0,0
"540","T","VSN-G",0.007,0,0,0,0,0
"541","T","VSN-G",0.008,0,0,0,0,0
"542","T","VSN-G",0.009,0,0,0,0,0
"543","T","VSN-G",0.01,0,0,0,0,6
"544","T","VSN-G",0.02,0,0,0,0,11
"545","T","VSN-G",0.03,0,0,0,0,11
"546","T","VSN-G",0.04,0,0,0,0,11
"547","T","VSN-G",0.05,0,0,0,0,20
"548","T","VSN-G",0.06,0,0,0,0,22
"551","T","VSN-G",0.09,0,0,0,0,40
"553","T","TI-G",1e-06,0,0,0,0,0
"554","T","TI-G",2e-06,0,0,0,0,0
"555","T","TI-G",3e-06,0,0,0,0,0
"556","T","TI-G",4e-06,0,0,0,0,0
"557","T","TI-G",5e-06,0,0,0,0,0
"558","T","TI-G",6e-06,0,0,0,0,0
"559","T","TI-G",7e-06,0,0,0,0,0
"560","T","TI-G",8e-06,0,0,0,0,0
"561","T","TI-G",9e-06,0,0,0,0,0
"562","T","TI-G",1e-05,0,0,0,0,0
"563","T","TI-G",2e-05,0,0,0,0,0
"564","T","TI-G",3e-05,0,0,0,0,0
"565","T","TI-G",4e-05,0,0,0,0,0
"566","T","TI-G",5e-05,0,0,0,0,0
"567","T","TI-G",6e-05,0,0,0,0,0
"568","T","TI-G",7e-05,0,0,0,0,0
"569","T","TI-G",8e-05,0,0,0,0,0
"570","T","TI-G",9e-05,0,0,0,0,0
"571","T","TI-G",1e-04,0,0,0,0,0
"572","T","TI-G",2e-04,0,0,0,0,0
"573","T","TI-G",3e-04,0,0,0,0,0
"574","T","TI-G",4e-04,0,0,0,0,0
"575","T","TI-G",5e-04,0,0,0,0,0
"576","T","TI-G",6e-04,0,0,0,0,0
"577","T","TI-G",7e-04,0,0,0,0,0
"578","T","TI-G",8e-04,0,0,0,0,0
"579","T","TI-G",9e-04,0,0,0,0,0
"580","T","TI-G",0.001,0,0,0,0,0
"581","T","TI-G",0.002,0,0,0,0,0
"582","T","TI-G",0.003,0,0,0,0,0
"583","T","TI-G",0.004,0,0,0,0,0
"584","T","TI-G",0.005,0,0,0,0,0
"585","T","TI-G",0.006,0,0,0,0,0
"586","T","TI-G",0.007,0,0,0,0,0
"587","T","TI-G",0.008,0,0,0,0,0
"588","T","TI-G",0.009,0,0,0,0,0
"589","T","TI-G",0.01,0,0,0,0,0
"590","T","TI-G",0.02,0,0,0,0,7
"591","T","TI-G",0.03,0,0,0,0,9
"592","T","TI-G",0.04,0,0,0,0,13
"593","T","TI-G",0.05,0,0,0,0,16
"594","T","TI-G",0.06,0,0,0,0,17
"595","T","TI-G",0.07,0,0,0,0,20
"596","T","TI-G",0.08,0,0,0,0,21
"597","T","TI-G",0.09,0,0,0,0,23
"598","T","TI-G",0.1,0,0,0,0,40
"599","T","MedI-G",1e-06,0,0,0,0,0
"600","T","MedI-G",2e-06,0,0,0,0,0
"601","T","MedI-G",3e-06,0,0,0,0,0
"602","T","MedI-G",4e-06,0,0,0,0,0
"603","T","MedI-G",5e-06,0,0,0,0,0
"604","T","MedI-G",6e-06,0,0,0,0,0
"605","T","MedI-G",7e-06,0,0,0,0,0
"606","T","MedI-G",8e-06,0,0,0,0,0
"607","T","MedI-G",9e-06,0,0,0,0,0
"608","T","MedI-G",1e-05,0,0,0,0,0
"609","T","MedI-G",2e-05,0,0,0,0,0
"610","T","MedI-G",3e-05,0,0,0,0,0
"611","T","MedI-G",4e-05,0,0,0,0,0
"612","T","MedI-G",5e-05,0,0,0,0,0
"613","T","MedI-G",6e-05,0,0,0,0,0
"614","T","MedI-G",7e-05,0,0,0,0,0
"615","T","MedI-G",8e-05,0,0,0,0,0
"616","T","MedI-G",9e-05,0,0,0,0,0
"617","T","MedI-G",1e-04,0,0,0,0,0
"618","T","MedI-G",2e-04,0,0,0,0,0
"619","T","MedI-G",3e-04,0,0,0,0,0
"620","T","MedI-G",4e-04,0,0,0,0,0
"621","T","MedI-G",5e-04,0,0,0,0,0
"622","T","MedI-G",6e-04,0,0,0,0,0
"623","T","MedI-G",7e-04,0,0,0,0,0
"624","T","MedI-G",8e-04,0,0,0,0,0
"625","T","MedI-G",9e-04,0,0,0,0,0
"626","T","MedI-G",0.001,0,0,0,0,0
"627","T","MedI-G",0.002,0,0,0,0,0
"628","T","MedI-G",0.003,0,0,0,0,0
"629","T","MedI-G",0.004,0,0,0,0,1
"630","T","MedI-G",0.005,0,0,0,0,1
"631","T","MedI-G",0.006,0,0,0,0,1
"632","T","MedI-G",0.007,0,0,0,0,6
"645","T","AI-G",1e-06,0,0,0,0,0
"646","T","AI-G",2e-06,0,0,0,0,0
"647","T","AI-G",3e-06,0,0,0,0,0
"648","T","AI-G",4e-06,0,0,0,0,0
"649","T","AI-G",5e-06,0,0,0,0,0
"650","T","AI-G",6e-06,0,0,0,0,0
"651","T","AI-G",7e-06,0,0,0,0,0
"652","T","AI-G",8e-06,0,0,0,0,0
"653","T","AI-G",9e-06,0,0,0,0,0
"654","T","AI-G",1e-05,0,0,0,0,0
"655","T","AI-G",2e-05,0,0,0,0,0
"656","T","AI-G",3e-05,0,0,0,0,0
"657","T","AI-G",4e-05,0,0,0,0,0
"658","T","AI-G",5e-05,0,0,0,0,0
"659","T","AI-G",6e-05,0,0,0,0,0
"660","T","AI-G",7e-05,0,0,0,0,0
"661","T","AI-G",8e-05,0,0,0,0,0
"662","T","AI-G",9e-05,0,0,0,0,0
"663","T","AI-G",1e-04,0,0,0,0,0
"664","T","AI-G",2e-04,0,0,0,0,0
"665","T","AI-G",3e-04,0,0,0,0,0
"666","T","AI-G",4e-04,0,0,0,0,0
"667","T","AI-G",5e-04,0,0,0,0,0
"668","T","AI-G",6e-04,0,0,0,0,0
"669","T","AI-G",7e-04,0,0,0,0,0
"670","T","AI-G",8e-04,0,0,0,0,0
"671","T","AI-G",9e-04,0,0,0,0,0
"672","T","AI-G",0.001,0,0,0,0,0
"673","T","AI-G",0.002,0,0,0,0,0
"674","T","AI-G",0.003,0,0,0,0,0
"675","T","AI-G",0.004,0,0,0,0,0
"676","T","AI-G",0.005,0,0,0,0,0
"677","T","AI-G",0.006,0,0,0,0,0
"678","T","AI-G",0.007,0,0,0,0,0
"679","T","AI-G",0.008,0,0,0,0,0
"680","T","AI-G",0.009,0,0,0,0,0
"681","T","AI-G",0.01,0,0,0,0,0
"682","T","AI-G",0.02,0,0,0,0,7
"683","T","AI-G",0.03,0,0,0,0,9
"684","T","AI-G",0.04,0,0,0,0,13
"685","T","AI-G",0.05,0,0,0,0,16
"686","T","AI-G",0.06,0,0,0,0,17
"687","T","AI-G",0.07,0,0,0,0,20
"688","T","AI-G",0.08,0,0,0,0,21
"689","T","AI-G",0.09,0,0,0,0,23
"690","T","AI-G",0.1,0,0,0,0,40
"691","T","Quantile",1e-06,0,0,0,0,0
"692","T","Quantile",2e-06,0,0,0,0,0
"693","T","Quantile",3e-06,0,0,0,0,0
"694","T","Quantile",4e-06,0,0,0,0,0
"695","T","Quantile",5e-06,0,0,0,0,0
"696","T","Quantile",6e-06,0,0,0,0,0
"697","T","Quantile",7e-06,0,0,0,0,0
"698","T","Quantile",8e-06,0,0,0,0,0
"699","T","Quantile",9e-06,0,0,0,0,0
"700","T","Quantile",1e-05,0,0,0,0,0
"701","T","Quantile",2e-05,0,0,0,0,0
"702","T","Quantile",3e-05,0,0,0,0,0
"703","T","Quantile",4e-05,0,0,0,0,0
"704","T","Quantile",5e-05,0,0,0,0,0
"705","T","Quantile",6e-05,0,0,0,0,0
"706","T","Quantile",7e-05,0,0,0,0,0
"707","T","Quantile",8e-05,0,0,0,0,0
"708","T","Quantile",9e-05,0,0,0,0,0
"709","T","Quantile",1e-04,0,0,0,0,0
"710","T","Quantile",2e-04,0,0,0,0,0
"711","T","Quantile",3e-04,0,0,0,0,0
"712","T","Quantile",4e-04,0,0,0,0,0
"713","T","Quantile",5e-04,0,0,0,0,0
"714","T","Quantile",6e-04,0,0,0,0,0
"715","T","Quantile",7e-04,0,0,0,0,0
"716","T","Quantile",8e-04,0,0,0,0,0
"717","T","Quantile",9e-04,0,0,0,0,0
"718","T","Quantile",0.001,0,0,0,0,0
"719","T","Quantile",0.002,0,0,0,0,0
"720","T","Quantile",0.003,0,0,0,0,0
"721","T","Quantile",0.004,0,0,0,0,0
"722","T","Quantile",0.005,0,0,0,0,2
"723","T","Quantile",0.006,0,0,0,0,3
"724","T","Quantile",0.007,0,0,0,0,3
"725","T","Quantile",0.008,0,0,0,0,3
"726","T","Quantile",0.009,0,0,0,0,4
"727","T","Quantile",0.01,0,0,0,0,4
"728","T","Quantile",0.02,0,0,0,0,14
"729","T","Quantile",0.03,0,0,0,0,20
"730","T","Quantile",0.04,0,0,0,0,28
"731","T","Quantile",0.05,0,0,0,0,31
"732","T","Quantile",0.06,0,0,0,0,33
"733","T","Quantile",0.07,0,0,0,0,36
"734","T","Quantile",0.08,0,0,0,0,38
"735","T","Quantile",0.09,0,0,0,0,40
"736","T","Quantile",0.1,0,0,0,0,44
