"","DE","Normalisation","Threshold","Go_BP","Go_MF","Go_CC","Total","DEs"
"46","QM","None",0.1,76,14,15,105,194
"44","QM","None",0.08,70,14,15,99,182
"45","QM","None",0.09,70,13,16,99,187
"41","QM","None",0.05,67,14,16,97,141
"42","QM","None",0.06,65,12,14,91,163
"43","QM","None",0.07,65,10,14,89,169
"35","QM","None",0.008,59,7,12,78,66
"37","QM","None",0.01,55,7,13,75,71
"38","QM","None",0.02,54,7,14,75,91
"24","QM","None",6e-04,56,6,11,73,22
"28","QM","None",0.001,53,7,13,73,28
"26","QM","None",8e-04,55,5,12,72,25
"27","QM","None",9e-04,55,5,12,72,25
"33","QM","None",0.006,50,9,13,72,63
"34","QM","None",0.007,53,7,12,72,65
"36","QM","None",0.009,54,7,11,72,69
"40","QM","None",0.04,49,8,15,72,122
"184","QM","VSN-G",0.1,42,11,19,72,498
"25","QM","None",7e-04,53,5,13,71,24
"39","QM","None",0.03,46,9,14,69,111
"32","QM","None",0.005,49,8,11,68,60
"166","QM","VSN-G",0.001,43,10,14,67,115
"31","QM","None",0.004,43,8,14,65,50
"178","QM","VSN-G",0.04,41,8,16,65,348
"179","QM","VSN-G",0.05,42,8,15,65,375
"183","QM","VSN-G",0.09,41,8,16,65,473
"351","QM","Quantile",0.002,42,9,13,64,134
"164","QM","VSN-G",8e-04,42,7,13,62,110
"176","QM","VSN-G",0.02,36,12,14,62,273
"180","QM","VSN-G",0.06,40,7,15,62,403
"181","QM","VSN-G",0.07,36,10,16,62,421
"165","QM","VSN-G",9e-04,41,7,13,61,111
"352","QM","Quantile",0.003,41,7,13,61,147
"354","QM","Quantile",0.005,40,7,14,61,173
"29","QM","None",0.002,46,4,10,60,37
"158","QM","VSN-G",2e-04,41,8,11,60,69
"160","QM","VSN-G",4e-04,43,7,10,60,87
"172","QM","VSN-G",0.007,36,11,13,60,188
"159","QM","VSN-G",3e-04,41,7,11,59,78
"169","QM","VSN-G",0.004,37,8,14,59,163
"30","QM","None",0.003,39,6,13,58,45
"155","QM","VSN-G",8e-05,41,5,12,58,59
"177","QM","VSN-G",0.03,33,9,15,57,304
"346","QM","Quantile",6e-04,40,7,10,57,98
"353","QM","Quantile",0.004,38,5,14,57,162
"355","QM","Quantile",0.006,37,7,13,57,186
"357","QM","Quantile",0.008,35,6,16,57,208
"173","QM","VSN-G",0.008,37,6,13,56,201
"358","QM","Quantile",0.009,35,6,15,56,219
"162","QM","VSN-G",6e-04,38,8,9,55,99
"163","QM","VSN-G",7e-04,39,6,10,55,106
"168","QM","VSN-G",0.003,38,4,13,55,145
"182","QM","VSN-G",0.08,31,8,16,55,445
"350","QM","Quantile",0.001,40,4,11,55,113
"23","QM","None",5e-04,36,7,11,54,20
"356","QM","Quantile",0.007,34,5,15,54,194
"365","QM","Quantile",0.07,34,7,13,54,479
"154","QM","VSN-G",7e-05,37,5,11,53,57
"343","QM","Quantile",3e-04,36,6,11,53,74
"171","QM","VSN-G",0.006,35,3,14,52,185
"167","QM","VSN-G",0.002,35,3,13,51,137
"175","QM","VSN-G",0.01,31,7,13,51,211
"359","QM","Quantile",0.01,33,6,12,51,224
"156","QM","VSN-G",9e-05,33,5,12,50,60
"157","QM","VSN-G",1e-04,33,5,12,50,60
"161","QM","VSN-G",5e-04,38,3,9,50,94
"170","QM","VSN-G",0.005,33,5,12,50,173
"368","QM","Quantile",0.1,29,6,14,49,560
"174","QM","VSN-G",0.009,29,6,13,48,207
"348","QM","Quantile",8e-04,34,4,10,48,107
"349","QM","Quantile",9e-04,33,4,11,48,112
"362","QM","Quantile",0.04,29,7,12,48,395
"347","QM","Quantile",7e-04,32,5,10,47,104
"361","QM","Quantile",0.03,26,9,12,47,346
"87","QM","Loess-G",0.05,34,5,7,46,105
"153","QM","VSN-G",6e-05,32,4,9,45,52
"360","QM","Quantile",0.02,26,7,12,45,302
"363","QM","Quantile",0.05,28,6,11,45,426
"85","QM","Loess-G",0.03,33,5,5,43,77
"128","QM","RLR-G",0.009,30,4,9,43,110
"129","QM","RLR-G",0.01,32,2,9,43,114
"345","QM","Quantile",5e-04,32,1,10,43,90
"364","QM","Quantile",0.06,25,6,12,43,451
"367","QM","Quantile",0.09,27,4,12,43,529
"127","QM","RLR-G",0.008,30,3,9,42,107
"366","QM","Quantile",0.08,23,6,13,42,503
"86","QM","Loess-G",0.04,32,4,4,40,92
"134","QM","RLR-G",0.06,23,6,11,40,262
"130","QM","RLR-G",0.02,30,1,8,39,160
"344","QM","Quantile",4e-04,26,3,10,39,80
"126","QM","RLR-G",0.007,27,2,9,38,106
"133","QM","RLR-G",0.05,24,5,9,38,229
"135","QM","RLR-G",0.07,22,7,9,38,285
"136","QM","RLR-G",0.08,20,7,11,38,312
"339","QM","Quantile",8e-05,26,3,9,38,50
"88","QM","Loess-G",0.06,29,1,7,37,118
"122","QM","RLR-G",0.003,31,1,5,37,78
"137","QM","RLR-G",0.09,20,7,10,37,338
"138","QM","RLR-G",0.1,20,8,9,37,358
"340","QM","Quantile",9e-05,25,3,9,37,54
"341","QM","Quantile",1e-04,25,4,8,37,55
"123","QM","RLR-G",0.004,30,1,5,36,88
"124","QM","RLR-G",0.005,30,1,5,36,92
"342","QM","Quantile",2e-04,25,4,7,36,66
"92","QM","Loess-G",0.1,28,1,6,35,162
"125","QM","RLR-G",0.006,28,2,5,35,101
"132","QM","RLR-G",0.04,27,1,7,35,208
"151","QM","VSN-G",4e-05,28,0,7,35,45
"152","QM","VSN-G",5e-05,28,0,7,35,47
"131","QM","RLR-G",0.03,24,1,9,34,187
"90","QM","Loess-G",0.08,25,1,7,33,144
"89","QM","Loess-G",0.07,24,1,7,32,134
"91","QM","Loess-G",0.09,22,1,9,32,151
"331","QM","Quantile",9e-06,27,3,2,32,30
"332","QM","Quantile",1e-05,27,3,2,32,30
"84","QM","Loess-G",0.02,24,3,4,31,59
"549","T","VSN-G",0.07,27,2,1,30,29
"333","QM","Quantile",2e-05,21,3,5,29,35
"338","QM","Quantile",7e-05,18,3,8,29,47
"336","QM","Quantile",5e-05,16,3,7,26,42
"550","T","VSN-G",0.08,23,2,1,26,37
"22","QM","None",4e-04,18,3,4,25,17
"334","QM","Quantile",3e-05,19,3,3,25,38
"337","QM","Quantile",6e-05,15,3,7,25,45
"438","T","Loess-G",6e-04,22,3,0,25,6
"439","T","Loess-G",7e-04,22,3,0,25,6
"440","T","Loess-G",8e-04,22,3,0,25,6
"551","T","VSN-G",0.09,21,2,1,24,41
"725","T","Quantile",0.008,19,3,2,24,9
"446","T","Loess-G",0.005,18,3,2,23,11
"58","QM","Loess-G",3e-05,16,3,3,22,2
"59","QM","Loess-G",4e-05,16,3,3,22,2
"60","QM","Loess-G",5e-05,16,3,3,22,2
"61","QM","Loess-G",6e-05,16,3,3,22,2
"62","QM","Loess-G",7e-05,16,3,3,22,2
"455","T","Loess-G",0.05,19,2,1,22,28
"519","T","VSN-G",4e-05,17,3,2,22,3
"520","T","VSN-G",5e-05,17,3,2,22,3
"521","T","VSN-G",6e-05,17,3,2,22,3
"522","T","VSN-G",7e-05,17,3,2,22,3
"523","T","VSN-G",8e-05,17,3,2,22,3
"524","T","VSN-G",9e-05,17,3,2,22,3
"525","T","VSN-G",1e-04,17,3,2,22,3
"526","T","VSN-G",2e-04,17,3,2,22,3
"527","T","VSN-G",3e-04,17,3,2,22,3
"528","T","VSN-G",4e-04,17,3,2,22,3
"529","T","VSN-G",5e-04,17,3,2,22,3
"530","T","VSN-G",6e-04,17,3,2,22,3
"531","T","VSN-G",7e-04,17,3,2,22,3
"532","T","VSN-G",8e-04,17,3,2,22,3
"533","T","VSN-G",9e-04,17,3,2,22,3
"534","T","VSN-G",0.001,17,3,2,22,3
"329","QM","Quantile",7e-06,19,1,1,21,26
"330","QM","Quantile",8e-06,19,1,1,21,27
"335","QM","Quantile",4e-05,15,3,3,21,40
"445","T","Loess-G",0.004,16,3,2,21,10
"535","T","VSN-G",0.002,16,3,1,20,5
"536","T","VSN-G",0.003,16,3,1,20,5
"539","T","VSN-G",0.006,16,3,1,20,10
"724","T","Quantile",0.007,15,3,2,20,8
"21","QM","None",3e-04,12,3,4,19,16
"117","QM","RLR-G",7e-04,15,2,2,19,38
"328","QM","Quantile",6e-06,17,1,1,19,24
"441","T","Loess-G",9e-04,19,0,0,19,7
"442","T","Loess-G",0.001,19,0,0,19,7
"443","T","Loess-G",0.002,19,0,0,19,7
"552","T","VSN-G",0.1,16,2,1,19,44
"726","T","Quantile",0.009,13,3,2,18,12
"727","T","Quantile",0.01,13,3,2,18,12
"17","QM","None",8e-05,11,3,3,17,7
"326","QM","Quantile",4e-06,15,1,1,17,20
"456","T","Loess-G",0.06,14,2,1,17,33
"540","T","VSN-G",0.007,13,4,0,17,12
"541","T","VSN-G",0.008,13,4,0,17,12
"542","T","VSN-G",0.009,13,4,0,17,12
"543","T","VSN-G",0.01,13,4,0,17,12
"544","T","VSN-G",0.02,13,4,0,17,13
"545","T","VSN-G",0.03,14,2,1,17,16
"719","T","Quantile",0.002,14,3,0,17,4
"325","QM","Quantile",3e-06,14,1,1,16,18
"327","QM","Quantile",5e-06,14,1,1,16,21
"434","T","Loess-G",2e-04,16,0,0,16,4
"435","T","Loess-G",3e-04,16,0,0,16,4
"436","T","Loess-G",4e-04,16,0,0,16,4
"437","T","Loess-G",5e-04,16,0,0,16,4
"444","T","Loess-G",0.003,16,0,0,16,8
"493","T","RLR-G",0.006,16,0,0,16,9
"118","QM","RLR-G",8e-04,12,2,1,15,40
"457","T","Loess-G",0.07,12,2,1,15,38
"494","T","RLR-G",0.007,15,0,0,15,10
"500","T","RLR-G",0.04,12,2,1,15,25
"501","T","RLR-G",0.05,12,2,1,15,25
"547","T","VSN-G",0.05,12,2,1,15,26
"548","T","VSN-G",0.06,12,2,1,15,27
"598","T","TI-G",0.1,13,0,2,15,561
"690","T","AI-G",0.1,13,0,2,15,561
"121","QM","RLR-G",0.002,12,0,2,14,63
"447","T","Loess-G",0.006,11,3,0,14,12
"448","T","Loess-G",0.007,11,3,0,14,12
"449","T","Loess-G",0.008,11,3,0,14,12
"450","T","Loess-G",0.009,11,3,0,14,12
"458","T","Loess-G",0.08,11,2,1,14,43
"459","T","Loess-G",0.09,11,2,1,14,45
"460","T","Loess-G",0.1,11,2,1,14,51
"497","T","RLR-G",0.01,11,3,0,14,13
"499","T","RLR-G",0.03,12,2,0,14,22
"502","T","RLR-G",0.06,11,2,1,14,27
"537","T","VSN-G",0.004,10,3,1,14,6
"736","T","Quantile",0.1,11,2,1,14,41
"139","QM","VSN-G",1e-06,10,1,2,13,13
"454","T","Loess-G",0.04,10,2,1,13,24
"596","T","TI-G",0.08,9,0,4,13,476
"688","T","AI-G",0.08,9,0,4,13,476
"18","QM","None",9e-05,6,3,3,12,8
"19","QM","None",1e-04,6,3,3,12,8
"487","T","RLR-G",9e-04,12,0,0,12,4
"488","T","RLR-G",0.001,12,0,0,12,4
"495","T","RLR-G",0.008,12,0,0,12,11
"496","T","RLR-G",0.009,12,0,0,12,11
"505","T","RLR-G",0.09,9,2,1,12,39
"506","T","RLR-G",0.1,9,2,1,12,39
"546","T","VSN-G",0.04,9,2,1,12,21
"595","T","TI-G",0.07,9,0,3,12,433
"687","T","AI-G",0.07,9,0,3,12,433
"720","T","Quantile",0.003,11,0,1,12,7
"721","T","Quantile",0.004,11,0,1,12,7
"722","T","Quantile",0.005,11,0,1,12,7
"723","T","Quantile",0.006,11,0,1,12,7
"1","QM","None",1e-06,6,5,0,11,1
"411","T","None",0.07,6,5,0,11,1
"415","T","Loess-G",1e-06,10,0,1,11,1
"416","T","Loess-G",2e-06,10,0,1,11,1
"417","T","Loess-G",3e-06,10,0,1,11,1
"418","T","Loess-G",4e-06,10,0,1,11,1
"419","T","Loess-G",5e-06,10,0,1,11,1
"420","T","Loess-G",6e-06,10,0,1,11,1
"421","T","Loess-G",7e-06,10,0,1,11,1
"422","T","Loess-G",8e-06,10,0,1,11,1
"423","T","Loess-G",9e-06,10,0,1,11,1
"424","T","Loess-G",1e-05,10,0,1,11,1
"425","T","Loess-G",2e-05,10,0,1,11,1
"426","T","Loess-G",3e-05,10,0,1,11,1
"427","T","Loess-G",4e-05,10,0,1,11,1
"428","T","Loess-G",5e-05,10,0,1,11,1
"429","T","Loess-G",6e-05,10,0,1,11,1
"430","T","Loess-G",7e-05,10,0,1,11,1
"431","T","Loess-G",8e-05,10,0,1,11,1
"432","T","Loess-G",9e-05,10,0,1,11,1
"433","T","Loess-G",1e-04,10,0,1,11,1
"451","T","Loess-G",0.01,8,3,0,11,13
"461","T","RLR-G",1e-06,10,0,1,11,1
"462","T","RLR-G",2e-06,10,0,1,11,1
"463","T","RLR-G",3e-06,10,0,1,11,1
"464","T","RLR-G",4e-06,10,0,1,11,1
"465","T","RLR-G",5e-06,10,0,1,11,1
"466","T","RLR-G",6e-06,10,0,1,11,1
"467","T","RLR-G",7e-06,10,0,1,11,1
"468","T","RLR-G",8e-06,10,0,1,11,1
"469","T","RLR-G",9e-06,10,0,1,11,1
"470","T","RLR-G",1e-05,10,0,1,11,1
"471","T","RLR-G",2e-05,10,0,1,11,1
"472","T","RLR-G",3e-05,10,0,1,11,1
"473","T","RLR-G",4e-05,10,0,1,11,1
"474","T","RLR-G",5e-05,10,0,1,11,1
"475","T","RLR-G",6e-05,10,0,1,11,1
"476","T","RLR-G",7e-05,10,0,1,11,1
"477","T","RLR-G",8e-05,10,0,1,11,1
"478","T","RLR-G",9e-05,10,0,1,11,1
"479","T","RLR-G",1e-04,10,0,1,11,1
"480","T","RLR-G",2e-04,10,0,1,11,1
"481","T","RLR-G",3e-04,10,0,1,11,1
"482","T","RLR-G",4e-04,10,0,1,11,1
"483","T","RLR-G",5e-04,10,0,1,11,1
"484","T","RLR-G",6e-04,10,0,1,11,1
"485","T","RLR-G",7e-04,10,0,1,11,1
"486","T","RLR-G",8e-04,10,0,1,11,1
"510","T","VSN-G",4e-06,10,0,1,11,1
"511","T","VSN-G",5e-06,10,0,1,11,1
"512","T","VSN-G",6e-06,10,0,1,11,1
"513","T","VSN-G",7e-06,10,0,1,11,1
"514","T","VSN-G",8e-06,10,0,1,11,1
"515","T","VSN-G",9e-06,10,0,1,11,1
"516","T","VSN-G",1e-05,10,0,1,11,1
"517","T","VSN-G",2e-05,10,0,1,11,1
"518","T","VSN-G",3e-05,10,0,1,11,1
"691","T","Quantile",1e-06,10,0,1,11,1
"692","T","Quantile",2e-06,10,0,1,11,1
"693","T","Quantile",3e-06,10,0,1,11,1
"694","T","Quantile",4e-06,10,0,1,11,1
"695","T","Quantile",5e-06,10,0,1,11,1
"696","T","Quantile",6e-06,10,0,1,11,1
"697","T","Quantile",7e-06,10,0,1,11,1
"698","T","Quantile",8e-06,10,0,1,11,1
"699","T","Quantile",9e-06,10,0,1,11,1
"700","T","Quantile",1e-05,10,0,1,11,1
"701","T","Quantile",2e-05,10,0,1,11,1
"702","T","Quantile",3e-05,10,0,1,11,1
"703","T","Quantile",4e-05,10,0,1,11,1
"704","T","Quantile",5e-05,10,0,1,11,1
"705","T","Quantile",6e-05,10,0,1,11,1
"706","T","Quantile",7e-05,10,0,1,11,1
"707","T","Quantile",8e-05,10,0,1,11,1
"708","T","Quantile",9e-05,10,0,1,11,1
"709","T","Quantile",1e-04,10,0,1,11,1
"710","T","Quantile",2e-04,10,0,1,11,1
"711","T","Quantile",3e-04,10,0,1,11,1
"712","T","Quantile",4e-04,10,0,1,11,1
"104","QM","RLR-G",3e-05,7,1,2,10,10
"452","T","Loess-G",0.02,7,3,0,10,16
"489","T","RLR-G",0.002,10,0,0,10,7
"538","T","VSN-G",0.005,6,3,1,10,8
"618","T","MedI-G",2e-04,9,1,0,10,1
"619","T","MedI-G",3e-04,9,1,0,10,1
"620","T","MedI-G",4e-04,9,1,0,10,1
"621","T","MedI-G",5e-04,9,1,0,10,1
"622","T","MedI-G",6e-04,9,1,0,10,1
"623","T","MedI-G",7e-04,9,1,0,10,1
"624","T","MedI-G",8e-04,9,1,0,10,1
"625","T","MedI-G",9e-04,9,1,0,10,1
"626","T","MedI-G",0.001,9,1,0,10,1
"627","T","MedI-G",0.002,9,1,0,10,1
"628","T","MedI-G",0.003,9,1,0,10,1
"629","T","MedI-G",0.004,9,1,0,10,1
"630","T","MedI-G",0.005,9,1,0,10,1
"503","T","RLR-G",0.07,6,2,1,9,32
"563","T","TI-G",2e-05,0,0,9,9,1
"564","T","TI-G",3e-05,0,0,9,9,1
"565","T","TI-G",4e-05,0,0,9,9,1
"566","T","TI-G",5e-05,0,0,9,9,1
"567","T","TI-G",6e-05,0,0,9,9,1
"568","T","TI-G",7e-05,0,0,9,9,1
"569","T","TI-G",8e-05,0,0,9,9,1
"570","T","TI-G",9e-05,0,0,9,9,1
"571","T","TI-G",1e-04,0,0,9,9,1
"572","T","TI-G",2e-04,0,0,9,9,1
"597","T","TI-G",0.09,8,0,1,9,524
"655","T","AI-G",2e-05,0,0,9,9,1
"656","T","AI-G",3e-05,0,0,9,9,1
"657","T","AI-G",4e-05,0,0,9,9,1
"658","T","AI-G",5e-05,0,0,9,9,1
"659","T","AI-G",6e-05,0,0,9,9,1
"660","T","AI-G",7e-05,0,0,9,9,1
"661","T","AI-G",8e-05,0,0,9,9,1
"662","T","AI-G",9e-05,0,0,9,9,1
"663","T","AI-G",1e-04,0,0,9,9,1
"664","T","AI-G",2e-04,0,0,9,9,1
"689","T","AI-G",0.09,8,0,1,9,524
"732","T","Quantile",0.06,6,2,1,9,27
"149","QM","VSN-G",2e-05,0,4,4,8,34
"453","T","Loess-G",0.03,7,0,1,8,17
"504","T","RLR-G",0.08,6,2,0,8,34
"728","T","Quantile",0.02,7,0,1,8,17
"729","T","Quantile",0.03,7,0,1,8,18
"735","T","Quantile",0.09,5,2,1,8,35
"109","QM","RLR-G",8e-05,0,0,7,7,14
"594","T","TI-G",0.06,5,2,0,7,380
"686","T","AI-G",0.06,5,2,0,7,380
"119","QM","RLR-G",9e-04,6,0,0,6,42
"498","T","RLR-G",0.02,6,0,0,6,16
"733","T","Quantile",0.07,5,0,1,6,34
"734","T","Quantile",0.08,5,0,1,6,34
"592","T","TI-G",0.04,4,0,1,5,278
"593","T","TI-G",0.05,4,0,1,5,340
"684","T","AI-G",0.04,4,0,1,5,278
"685","T","AI-G",0.05,4,0,1,5,340
"730","T","Quantile",0.04,5,0,0,5,23
"731","T","Quantile",0.05,5,0,0,5,24
"83","QM","Loess-G",0.01,3,1,0,4,35
"150","QM","VSN-G",3e-05,0,0,4,4,42
"585","T","TI-G",0.006,0,1,3,4,49
"587","T","TI-G",0.008,0,1,3,4,63
"588","T","TI-G",0.009,0,1,3,4,63
"677","T","AI-G",0.006,0,1,3,4,49
"679","T","AI-G",0.008,0,1,3,4,63
"680","T","AI-G",0.009,0,1,3,4,63
"105","QM","RLR-G",4e-05,0,1,2,3,11
"106","QM","RLR-G",5e-05,0,1,2,3,11
"107","QM","RLR-G",6e-05,0,1,2,3,11
"108","QM","RLR-G",7e-05,0,1,2,3,13
"584","T","TI-G",0.005,0,1,2,3,40
"586","T","TI-G",0.007,0,1,2,3,58
"676","T","AI-G",0.005,0,1,2,3,40
"678","T","AI-G",0.007,0,1,2,3,58
"20","QM","None",2e-04,0,0,2,2,11
"103","QM","RLR-G",2e-05,0,0,2,2,9
"591","T","TI-G",0.03,0,2,0,2,203
"683","T","AI-G",0.03,0,2,0,2,203
"120","QM","RLR-G",0.001,1,0,0,1,44
"582","T","TI-G",0.003,0,1,0,1,27
"583","T","TI-G",0.004,0,1,0,1,33
"589","T","TI-G",0.01,0,1,0,1,73
"674","T","AI-G",0.003,0,1,0,1,27
"675","T","AI-G",0.004,0,1,0,1,33
"681","T","AI-G",0.01,0,1,0,1,73
"2","QM","None",2e-06,0,0,0,0,2
"3","QM","None",3e-06,0,0,0,0,3
"4","QM","None",4e-06,0,0,0,0,3
"5","QM","None",5e-06,0,0,0,0,4
"6","QM","None",6e-06,0,0,0,0,4
"7","QM","None",7e-06,0,0,0,0,4
"8","QM","None",8e-06,0,0,0,0,5
"9","QM","None",9e-06,0,0,0,0,5
"10","QM","None",1e-05,0,0,0,0,5
"11","QM","None",2e-05,0,0,0,0,5
"12","QM","None",3e-05,0,0,0,0,5
"13","QM","None",4e-05,0,0,0,0,5
"14","QM","None",5e-05,0,0,0,0,6
"15","QM","None",6e-05,0,0,0,0,6
"16","QM","None",7e-05,0,0,0,0,6
"47","QM","Loess-G",1e-06,0,0,0,0,1
"48","QM","Loess-G",2e-06,0,0,0,0,1
"49","QM","Loess-G",3e-06,0,0,0,0,1
"50","QM","Loess-G",4e-06,0,0,0,0,1
"51","QM","Loess-G",5e-06,0,0,0,0,1
"52","QM","Loess-G",6e-06,0,0,0,0,1
"53","QM","Loess-G",7e-06,0,0,0,0,1
"54","QM","Loess-G",8e-06,0,0,0,0,1
"55","QM","Loess-G",9e-06,0,0,0,0,1
"56","QM","Loess-G",1e-05,0,0,0,0,1
"57","QM","Loess-G",2e-05,0,0,0,0,1
"63","QM","Loess-G",8e-05,0,0,0,0,3
"64","QM","Loess-G",9e-05,0,0,0,0,3
"65","QM","Loess-G",1e-04,0,0,0,0,3
"66","QM","Loess-G",2e-04,0,0,0,0,4
"67","QM","Loess-G",3e-04,0,0,0,0,5
"68","QM","Loess-G",4e-04,0,0,0,0,5
"69","QM","Loess-G",5e-04,0,0,0,0,5
"70","QM","Loess-G",6e-04,0,0,0,0,5
"71","QM","Loess-G",7e-04,0,0,0,0,7
"72","QM","Loess-G",8e-04,0,0,0,0,8
"73","QM","Loess-G",9e-04,0,0,0,0,10
"74","QM","Loess-G",0.001,0,0,0,0,10
"75","QM","Loess-G",0.002,0,0,0,0,19
"76","QM","Loess-G",0.003,0,0,0,0,23
"77","QM","Loess-G",0.004,0,0,0,0,25
"78","QM","Loess-G",0.005,0,0,0,0,25
"79","QM","Loess-G",0.006,0,0,0,0,25
"80","QM","Loess-G",0.007,0,0,0,0,29
"81","QM","Loess-G",0.008,0,0,0,0,31
"82","QM","Loess-G",0.009,0,0,0,0,33
"93","QM","RLR-G",1e-06,0,0,0,0,4
"94","QM","RLR-G",2e-06,0,0,0,0,4
"95","QM","RLR-G",3e-06,0,0,0,0,4
"96","QM","RLR-G",4e-06,0,0,0,0,4
"97","QM","RLR-G",5e-06,0,0,0,0,5
"98","QM","RLR-G",6e-06,0,0,0,0,5
"99","QM","RLR-G",7e-06,0,0,0,0,5
"100","QM","RLR-G",8e-06,0,0,0,0,5
"101","QM","RLR-G",9e-06,0,0,0,0,5
"102","QM","RLR-G",1e-05,0,0,0,0,6
"110","QM","RLR-G",9e-05,0,0,0,0,16
"111","QM","RLR-G",1e-04,0,0,0,0,17
"112","QM","RLR-G",2e-04,0,0,0,0,21
"113","QM","RLR-G",3e-04,0,0,0,0,25
"114","QM","RLR-G",4e-04,0,0,0,0,27
"115","QM","RLR-G",5e-04,0,0,0,0,31
"116","QM","RLR-G",6e-04,0,0,0,0,36
"140","QM","VSN-G",2e-06,0,0,0,0,15
"141","QM","VSN-G",3e-06,0,0,0,0,18
"142","QM","VSN-G",4e-06,0,0,0,0,19
"143","QM","VSN-G",5e-06,0,0,0,0,20
"144","QM","VSN-G",6e-06,0,0,0,0,22
"145","QM","VSN-G",7e-06,0,0,0,0,23
"146","QM","VSN-G",8e-06,0,0,0,0,25
"147","QM","VSN-G",9e-06,0,0,0,0,25
"148","QM","VSN-G",1e-05,0,0,0,0,28
"185","QM","TI-G",1e-06,0,0,0,0,5
"186","QM","TI-G",2e-06,0,0,0,0,5
"187","QM","TI-G",3e-06,0,0,0,0,5
"188","QM","TI-G",4e-06,0,0,0,0,5
"189","QM","TI-G",5e-06,0,0,0,0,5
"190","QM","TI-G",6e-06,0,0,0,0,5
"191","QM","TI-G",7e-06,0,0,0,0,5
"192","QM","TI-G",8e-06,0,0,0,0,5
"193","QM","TI-G",9e-06,0,0,0,0,5
"194","QM","TI-G",1e-05,0,0,0,0,5
"195","QM","TI-G",2e-05,0,0,0,0,5
"196","QM","TI-G",3e-05,0,0,0,0,5
"197","QM","TI-G",4e-05,0,0,0,0,5
"198","QM","TI-G",5e-05,0,0,0,0,6
"199","QM","TI-G",6e-05,0,0,0,0,7
"200","QM","TI-G",7e-05,0,0,0,0,7
"201","QM","TI-G",8e-05,0,0,0,0,7
"202","QM","TI-G",9e-05,0,0,0,0,7
"203","QM","TI-G",1e-04,0,0,0,0,7
"204","QM","TI-G",2e-04,0,0,0,0,7
"205","QM","TI-G",3e-04,0,0,0,0,7
"206","QM","TI-G",4e-04,0,0,0,0,8
"207","QM","TI-G",5e-04,0,0,0,0,8
"208","QM","TI-G",6e-04,0,0,0,0,8
"209","QM","TI-G",7e-04,0,0,0,0,8
"210","QM","TI-G",8e-04,0,0,0,0,8
"211","QM","TI-G",9e-04,0,0,0,0,8
"212","QM","TI-G",0.001,0,0,0,0,8
"213","QM","TI-G",0.002,0,0,0,0,9
"214","QM","TI-G",0.003,0,0,0,0,9
"215","QM","TI-G",0.004,0,0,0,0,10
"216","QM","TI-G",0.005,0,0,0,0,10
"217","QM","TI-G",0.006,0,0,0,0,10
"218","QM","TI-G",0.007,0,0,0,0,14
"219","QM","TI-G",0.008,0,0,0,0,14
"220","QM","TI-G",0.009,0,0,0,0,14
"221","QM","TI-G",0.01,0,0,0,0,15
"222","QM","TI-G",0.02,0,0,0,0,30
"223","QM","TI-G",0.03,0,0,0,0,40
"224","QM","TI-G",0.04,0,0,0,0,54
"225","QM","TI-G",0.05,0,0,0,0,66
"226","QM","TI-G",0.06,0,0,0,0,74
"227","QM","TI-G",0.07,0,0,0,0,82
"228","QM","TI-G",0.08,0,0,0,0,98
"229","QM","TI-G",0.09,0,0,0,0,102
"230","QM","TI-G",0.1,0,0,0,0,113
"231","QM","MedI-G",1e-06,0,0,0,0,4
"232","QM","MedI-G",2e-06,0,0,0,0,4
"233","QM","MedI-G",3e-06,0,0,0,0,4
"234","QM","MedI-G",4e-06,0,0,0,0,4
"235","QM","MedI-G",5e-06,0,0,0,0,4
"236","QM","MedI-G",6e-06,0,0,0,0,4
"237","QM","MedI-G",7e-06,0,0,0,0,4
"238","QM","MedI-G",8e-06,0,0,0,0,4
"239","QM","MedI-G",9e-06,0,0,0,0,4
"240","QM","MedI-G",1e-05,0,0,0,0,4
"241","QM","MedI-G",2e-05,0,0,0,0,4
"242","QM","MedI-G",3e-05,0,0,0,0,4
"243","QM","MedI-G",4e-05,0,0,0,0,4
"244","QM","MedI-G",5e-05,0,0,0,0,4
"245","QM","MedI-G",6e-05,0,0,0,0,4
"246","QM","MedI-G",7e-05,0,0,0,0,4
"247","QM","MedI-G",8e-05,0,0,0,0,4
"248","QM","MedI-G",9e-05,0,0,0,0,4
"249","QM","MedI-G",1e-04,0,0,0,0,4
"250","QM","MedI-G",2e-04,0,0,0,0,4
"251","QM","MedI-G",3e-04,0,0,0,0,4
"252","QM","MedI-G",4e-04,0,0,0,0,4
"253","QM","MedI-G",5e-04,0,0,0,0,5
"254","QM","MedI-G",6e-04,0,0,0,0,5
"255","QM","MedI-G",7e-04,0,0,0,0,6
"256","QM","MedI-G",8e-04,0,0,0,0,6
"257","QM","MedI-G",9e-04,0,0,0,0,6
"258","QM","MedI-G",0.001,0,0,0,0,6
"259","QM","MedI-G",0.002,0,0,0,0,9
"260","QM","MedI-G",0.003,0,0,0,0,9
"261","QM","MedI-G",0.004,0,0,0,0,9
"262","QM","MedI-G",0.005,0,0,0,0,9
"263","QM","MedI-G",0.006,0,0,0,0,9
"264","QM","MedI-G",0.007,0,0,0,0,9
"265","QM","MedI-G",0.008,0,0,0,0,10
"266","QM","MedI-G",0.009,0,0,0,0,13
"267","QM","MedI-G",0.01,0,0,0,0,15
"268","QM","MedI-G",0.02,0,0,0,0,22
"269","QM","MedI-G",0.03,0,0,0,0,34
"270","QM","MedI-G",0.04,0,0,0,0,40
"271","QM","MedI-G",0.05,0,0,0,0,51
"272","QM","MedI-G",0.06,0,0,0,0,67
"273","QM","MedI-G",0.07,0,0,0,0,77
"274","QM","MedI-G",0.08,0,0,0,0,84
"275","QM","MedI-G",0.09,0,0,0,0,94
"276","QM","MedI-G",0.1,0,0,0,0,102
"277","QM","AI-G",1e-06,0,0,0,0,0
"278","QM","AI-G",2e-06,0,0,0,0,0
"279","QM","AI-G",3e-06,0,0,0,0,0
"280","QM","AI-G",4e-06,0,0,0,0,0
"281","QM","AI-G",5e-06,0,0,0,0,0
"282","QM","AI-G",6e-06,0,0,0,0,0
"283","QM","AI-G",7e-06,0,0,0,0,0
"284","QM","AI-G",8e-06,0,0,0,0,0
"285","QM","AI-G",9e-06,0,0,0,0,0
"286","QM","AI-G",1e-05,0,0,0,0,0
"287","QM","AI-G",2e-05,0,0,0,0,0
"288","QM","AI-G",3e-05,0,0,0,0,0
"289","QM","AI-G",4e-05,0,0,0,0,0
"290","QM","AI-G",5e-05,0,0,0,0,0
"291","QM","AI-G",6e-05,0,0,0,0,0
"292","QM","AI-G",7e-05,0,0,0,0,0
"293","QM","AI-G",8e-05,0,0,0,0,0
"294","QM","AI-G",9e-05,0,0,0,0,0
"295","QM","AI-G",1e-04,0,0,0,0,0
"296","QM","AI-G",2e-04,0,0,0,0,0
"297","QM","AI-G",3e-04,0,0,0,0,0
"298","QM","AI-G",4e-04,0,0,0,0,0
"299","QM","AI-G",5e-04,0,0,0,0,0
"300","QM","AI-G",6e-04,0,0,0,0,0
"301","QM","AI-G",7e-04,0,0,0,0,0
"302","QM","AI-G",8e-04,0,0,0,0,0
"303","QM","AI-G",9e-04,0,0,0,0,0
"304","QM","AI-G",0.001,0,0,0,0,0
"305","QM","AI-G",0.002,0,0,0,0,0
"306","QM","AI-G",0.003,0,0,0,0,0
"307","QM","AI-G",0.004,0,0,0,0,0
"308","QM","AI-G",0.005,0,0,0,0,0
"309","QM","AI-G",0.006,0,0,0,0,0
"310","QM","AI-G",0.007,0,0,0,0,0
"311","QM","AI-G",0.008,0,0,0,0,0
"312","QM","AI-G",0.009,0,0,0,0,0
"313","QM","AI-G",0.01,0,0,0,0,0
"314","QM","AI-G",0.02,0,0,0,0,0
"315","QM","AI-G",0.03,0,0,0,0,0
"316","QM","AI-G",0.04,0,0,0,0,0
"317","QM","AI-G",0.05,0,0,0,0,0
"318","QM","AI-G",0.06,0,0,0,0,0
"319","QM","AI-G",0.07,0,0,0,0,0
"320","QM","AI-G",0.08,0,0,0,0,0
"321","QM","AI-G",0.09,0,0,0,0,3079
"322","QM","AI-G",0.1,0,0,0,0,3079
"323","QM","Quantile",1e-06,0,0,0,0,12
"324","QM","Quantile",2e-06,0,0,0,0,17
"369","T","None",1e-06,0,0,0,0,0
"370","T","None",2e-06,0,0,0,0,0
"371","T","None",3e-06,0,0,0,0,0
"372","T","None",4e-06,0,0,0,0,0
"373","T","None",5e-06,0,0,0,0,0
"374","T","None",6e-06,0,0,0,0,0
"375","T","None",7e-06,0,0,0,0,0
"376","T","None",8e-06,0,0,0,0,0
"377","T","None",9e-06,0,0,0,0,0
"378","T","None",1e-05,0,0,0,0,0
"379","T","None",2e-05,0,0,0,0,0
"380","T","None",3e-05,0,0,0,0,0
"381","T","None",4e-05,0,0,0,0,0
"382","T","None",5e-05,0,0,0,0,0
"383","T","None",6e-05,0,0,0,0,0
"384","T","None",7e-05,0,0,0,0,0
"385","T","None",8e-05,0,0,0,0,0
"386","T","None",9e-05,0,0,0,0,0
"387","T","None",1e-04,0,0,0,0,0
"388","T","None",2e-04,0,0,0,0,0
"389","T","None",3e-04,0,0,0,0,0
"390","T","None",4e-04,0,0,0,0,0
"391","T","None",5e-04,0,0,0,0,0
"392","T","None",6e-04,0,0,0,0,0
"393","T","None",7e-04,0,0,0,0,0
"394","T","None",8e-04,0,0,0,0,0
"395","T","None",9e-04,0,0,0,0,0
"396","T","None",0.001,0,0,0,0,0
"397","T","None",0.002,0,0,0,0,0
"398","T","None",0.003,0,0,0,0,0
"399","T","None",0.004,0,0,0,0,0
"400","T","None",0.005,0,0,0,0,0
"401","T","None",0.006,0,0,0,0,0
"402","T","None",0.007,0,0,0,0,0
"403","T","None",0.008,0,0,0,0,0
"404","T","None",0.009,0,0,0,0,0
"405","T","None",0.01,0,0,0,0,0
"406","T","None",0.02,0,0,0,0,0
"407","T","None",0.03,0,0,0,0,0
"408","T","None",0.04,0,0,0,0,0
"409","T","None",0.05,0,0,0,0,0
"410","T","None",0.06,0,0,0,0,0
"412","T","None",0.08,0,0,0,0,2
"413","T","None",0.09,0,0,0,0,2
"414","T","None",0.1,0,0,0,0,3
"490","T","RLR-G",0.003,0,0,0,0,8
"491","T","RLR-G",0.004,0,0,0,0,8
"492","T","RLR-G",0.005,0,0,0,0,8
"507","T","VSN-G",1e-06,0,0,0,0,0
"508","T","VSN-G",2e-06,0,0,0,0,0
"509","T","VSN-G",3e-06,0,0,0,0,0
"553","T","TI-G",1e-06,0,0,0,0,0
"554","T","TI-G",2e-06,0,0,0,0,0
"555","T","TI-G",3e-06,0,0,0,0,0
"556","T","TI-G",4e-06,0,0,0,0,0
"557","T","TI-G",5e-06,0,0,0,0,0
"558","T","TI-G",6e-06,0,0,0,0,0
"559","T","TI-G",7e-06,0,0,0,0,0
"560","T","TI-G",8e-06,0,0,0,0,0
"561","T","TI-G",9e-06,0,0,0,0,0
"562","T","TI-G",1e-05,0,0,0,0,0
"573","T","TI-G",3e-04,0,0,0,0,4
"574","T","TI-G",4e-04,0,0,0,0,6
"575","T","TI-G",5e-04,0,0,0,0,8
"576","T","TI-G",6e-04,0,0,0,0,9
"577","T","TI-G",7e-04,0,0,0,0,10
"578","T","TI-G",8e-04,0,0,0,0,10
"579","T","TI-G",9e-04,0,0,0,0,12
"580","T","TI-G",0.001,0,0,0,0,12
"581","T","TI-G",0.002,0,0,0,0,17
"590","T","TI-G",0.02,0,0,0,0,148
"599","T","MedI-G",1e-06,0,0,0,0,0
"600","T","MedI-G",2e-06,0,0,0,0,0
"601","T","MedI-G",3e-06,0,0,0,0,0
"602","T","MedI-G",4e-06,0,0,0,0,0
"603","T","MedI-G",5e-06,0,0,0,0,0
"604","T","MedI-G",6e-06,0,0,0,0,0
"605","T","MedI-G",7e-06,0,0,0,0,0
"606","T","MedI-G",8e-06,0,0,0,0,0
"607","T","MedI-G",9e-06,0,0,0,0,0
"608","T","MedI-G",1e-05,0,0,0,0,0
"609","T","MedI-G",2e-05,0,0,0,0,0
"610","T","MedI-G",3e-05,0,0,0,0,0
"611","T","MedI-G",4e-05,0,0,0,0,0
"612","T","MedI-G",5e-05,0,0,0,0,0
"613","T","MedI-G",6e-05,0,0,0,0,0
"614","T","MedI-G",7e-05,0,0,0,0,0
"615","T","MedI-G",8e-05,0,0,0,0,0
"616","T","MedI-G",9e-05,0,0,0,0,0
"617","T","MedI-G",1e-04,0,0,0,0,0
"631","T","MedI-G",0.006,0,0,0,0,2
"632","T","MedI-G",0.007,0,0,0,0,2
"633","T","MedI-G",0.008,0,0,0,0,2
"634","T","MedI-G",0.009,0,0,0,0,2
"635","T","MedI-G",0.01,0,0,0,0,3
"636","T","MedI-G",0.02,0,0,0,0,4
"637","T","MedI-G",0.03,0,0,0,0,6
"638","T","MedI-G",0.04,0,0,0,0,10
"639","T","MedI-G",0.05,0,0,0,0,10
"640","T","MedI-G",0.06,0,0,0,0,19
"641","T","MedI-G",0.07,0,0,0,0,22
"642","T","MedI-G",0.08,0,0,0,0,25
"643","T","MedI-G",0.09,0,0,0,0,31
"644","T","MedI-G",0.1,0,0,0,0,51
"645","T","AI-G",1e-06,0,0,0,0,0
"646","T","AI-G",2e-06,0,0,0,0,0
"647","T","AI-G",3e-06,0,0,0,0,0
"648","T","AI-G",4e-06,0,0,0,0,0
"649","T","AI-G",5e-06,0,0,0,0,0
"650","T","AI-G",6e-06,0,0,0,0,0
"651","T","AI-G",7e-06,0,0,0,0,0
"652","T","AI-G",8e-06,0,0,0,0,0
"653","T","AI-G",9e-06,0,0,0,0,0
"654","T","AI-G",1e-05,0,0,0,0,0
"665","T","AI-G",3e-04,0,0,0,0,4
"666","T","AI-G",4e-04,0,0,0,0,6
"667","T","AI-G",5e-04,0,0,0,0,8
"668","T","AI-G",6e-04,0,0,0,0,9
"669","T","AI-G",7e-04,0,0,0,0,10
"670","T","AI-G",8e-04,0,0,0,0,10
"671","T","AI-G",9e-04,0,0,0,0,12
"672","T","AI-G",0.001,0,0,0,0,12
"673","T","AI-G",0.002,0,0,0,0,17
"682","T","AI-G",0.02,0,0,0,0,148
"713","T","Quantile",5e-04,0,0,0,0,2
"714","T","Quantile",6e-04,0,0,0,0,2
"715","T","Quantile",7e-04,0,0,0,0,2
"716","T","Quantile",8e-04,0,0,0,0,2
"717","T","Quantile",9e-04,0,0,0,0,2
"718","T","Quantile",0.001,0,0,0,0,3
