"","DE","Normalisation","Threshold","Go_BP","Go_MF","Go_CC","Total","DEs"
"277","BT","VSN-G",1e-06,53,5,10,68,184
"289","BT","VSN-G",4e-05,43,3,12,58,239
"288","BT","VSN-G",3e-05,42,3,12,57,234
"282","BT","VSN-G",6e-06,42,3,10,55,210
"283","BT","VSN-G",7e-06,42,3,10,55,210
"287","BT","VSN-G",2e-05,41,2,11,54,228
"279","BT","VSN-G",3e-06,39,4,9,52,200
"293","BT","VSN-G",8e-05,39,2,11,52,249
"280","BT","VSN-G",4e-06,38,3,10,51,205
"281","BT","VSN-G",5e-06,38,3,10,51,208
"284","BT","VSN-G",8e-06,39,2,10,51,214
"294","BT","VSN-G",9e-05,35,3,12,50,251
"295","BT","VSN-G",1e-04,35,3,12,50,251
"292","BT","VSN-G",7e-05,35,3,11,49,248
"290","BT","VSN-G",5e-05,32,3,12,47,242
"285","BT","VSN-G",9e-06,35,2,8,45,217
"286","BT","VSN-G",1e-05,35,2,8,45,218
"291","BT","VSN-G",6e-05,28,3,12,43,243
"278","BT","VSN-G",2e-06,22,4,8,34,189
"297","BT","VSN-G",3e-04,1,0,13,14,272
"296","BT","VSN-G",2e-04,1,0,12,13,261
"298","BT","VSN-G",4e-04,0,0,13,13,275
"306","BT","VSN-G",0.003,0,1,10,11,310
"30","BT","None",0.003,0,5,5,10,188
"300","BT","VSN-G",6e-04,2,1,7,10,283
"301","BT","VSN-G",7e-04,2,0,8,10,286
"31","BT","None",0.004,0,5,4,9,193
"305","BT","VSN-G",0.002,1,0,8,9,300
"307","BT","VSN-G",0.004,0,0,9,9,314
"32","BT","None",0.005,0,4,4,8,201
"299","BT","VSN-G",5e-04,0,1,7,8,281
"303","BT","VSN-G",9e-04,0,0,8,8,290
"304","BT","VSN-G",0.001,0,0,8,8,290
"308","BT","VSN-G",0.005,0,0,8,8,320
"310","BT","VSN-G",0.007,0,0,8,8,326
"311","BT","VSN-G",0.008,0,0,8,8,328
"312","BT","VSN-G",0.009,0,0,8,8,329
"313","BT","VSN-G",0.01,0,0,8,8,330
"36","BT","None",0.009,0,3,4,7,212
"37","BT","None",0.01,0,3,4,7,216
"302","BT","VSN-G",8e-04,0,0,7,7,288
"309","BT","VSN-G",0.006,0,0,7,7,324
"20","BT","None",2e-04,0,6,0,6,153
"21","BT","None",3e-04,0,6,0,6,157
"2","BT","None",2e-06,0,5,0,5,107
"8","BT","None",8e-06,0,5,0,5,123
"9","BT","None",9e-06,0,5,0,5,124
"10","BT","None",1e-05,0,5,0,5,127
"11","BT","None",2e-05,0,5,0,5,132
"12","BT","None",3e-05,0,5,0,5,135
"22","BT","None",4e-04,0,5,0,5,161
"6","BT","None",6e-06,0,4,0,4,119
"7","BT","None",7e-06,0,4,0,4,119
"33","BT","None",0.006,0,0,4,4,205
"40","BT","None",0.04,0,1,3,4,263
"3","BT","None",3e-06,0,3,0,3,112
"4","BT","None",4e-06,0,3,0,3,115
"5","BT","None",5e-06,0,3,0,3,115
"34","BT","None",0.007,0,0,3,3,208
"35","BT","None",0.008,0,0,3,3,209
"39","BT","None",0.03,0,0,3,3,249
"41","BT","None",0.05,0,0,3,3,267
"42","BT","None",0.06,0,0,3,3,269
"38","BT","None",0.02,0,0,2,2,238
"43","BT","None",0.07,0,0,2,2,275
"44","BT","None",0.08,0,0,2,2,279
"45","BT","None",0.09,0,0,2,2,281
"46","BT","None",0.1,0,0,2,2,284
"315","BT","VSN-G",0.03,0,0,2,2,356
"316","BT","VSN-G",0.04,0,0,2,2,361
"317","BT","VSN-G",0.05,0,0,2,2,368
"318","BT","VSN-G",0.06,0,0,2,2,376
"125","BT","MedI-G",0.006,0,1,0,1,2
"126","BT","MedI-G",0.007,0,1,0,1,2
"127","BT","MedI-G",0.008,0,1,0,1,2
"128","BT","MedI-G",0.009,0,1,0,1,2
"129","BT","MedI-G",0.01,0,1,0,1,2
"188","BT","RLR-G",4e-06,1,0,0,1,104
"189","BT","RLR-G",5e-06,1,0,0,1,105
"190","BT","RLR-G",6e-06,1,0,0,1,105
"250","BT","Loess-G",2e-04,0,1,0,1,105
"251","BT","Loess-G",3e-04,0,1,0,1,115
"252","BT","Loess-G",4e-04,0,1,0,1,120
"253","BT","Loess-G",5e-04,0,1,0,1,120
"254","BT","Loess-G",6e-04,0,1,0,1,123
"255","BT","Loess-G",7e-04,0,1,0,1,126
"256","BT","Loess-G",8e-04,0,1,0,1,127
"257","BT","Loess-G",9e-04,0,1,0,1,130
"258","BT","Loess-G",0.001,0,1,0,1,131
"259","BT","Loess-G",0.002,0,1,0,1,139
"260","BT","Loess-G",0.003,0,1,0,1,141
"261","BT","Loess-G",0.004,0,1,0,1,147
"262","BT","Loess-G",0.005,0,1,0,1,153
"263","BT","Loess-G",0.006,0,1,0,1,156
"264","BT","Loess-G",0.007,0,1,0,1,157
"265","BT","Loess-G",0.008,0,1,0,1,159
"266","BT","Loess-G",0.009,0,1,0,1,161
"269","BT","Loess-G",0.03,0,1,0,1,202
"270","BT","Loess-G",0.04,0,1,0,1,217
"271","BT","Loess-G",0.05,0,1,0,1,221
"272","BT","Loess-G",0.06,0,1,0,1,232
"273","BT","Loess-G",0.07,0,1,0,1,240
"274","BT","Loess-G",0.08,0,1,0,1,245
"314","BT","VSN-G",0.02,0,0,1,1,347
"319","BT","VSN-G",0.07,0,0,1,1,382
"320","BT","VSN-G",0.08,0,0,1,1,383
"321","BT","VSN-G",0.09,0,0,1,1,390
"322","BT","VSN-G",0.1,0,0,1,1,392
"351","BT","Quantile",0.002,0,1,0,1,165
"352","BT","Quantile",0.003,0,1,0,1,174
"360","BT","Quantile",0.02,0,1,0,1,223
"361","BT","Quantile",0.03,0,1,0,1,237
"362","BT","Quantile",0.04,0,1,0,1,245
"364","BT","Quantile",0.06,0,1,0,1,265
"365","BT","Quantile",0.07,0,1,0,1,271
"1","BT","None",1e-06,0,0,0,0,101
"13","BT","None",4e-05,0,0,0,0,137
"14","BT","None",5e-05,0,0,0,0,139
"15","BT","None",6e-05,0,0,0,0,139
"16","BT","None",7e-05,0,0,0,0,141
"17","BT","None",8e-05,0,0,0,0,141
"18","BT","None",9e-05,0,0,0,0,142
"19","BT","None",1e-04,0,0,0,0,143
"23","BT","None",5e-04,0,0,0,0,166
"24","BT","None",6e-04,0,0,0,0,169
"25","BT","None",7e-04,0,0,0,0,170
"26","BT","None",8e-04,0,0,0,0,173
"27","BT","None",9e-04,0,0,0,0,173
"28","BT","None",0.001,0,0,0,0,176
"29","BT","None",0.002,0,0,0,0,181
"47","BT","AI-G",1e-06,0,0,0,0,0
"48","BT","AI-G",2e-06,0,0,0,0,0
"49","BT","AI-G",3e-06,0,0,0,0,0
"50","BT","AI-G",4e-06,0,0,0,0,0
"51","BT","AI-G",5e-06,0,0,0,0,0
"52","BT","AI-G",6e-06,0,0,0,0,0
"53","BT","AI-G",7e-06,0,0,0,0,0
"54","BT","AI-G",8e-06,0,0,0,0,0
"55","BT","AI-G",9e-06,0,0,0,0,0
"56","BT","AI-G",1e-05,0,0,0,0,0
"57","BT","AI-G",2e-05,0,0,0,0,0
"58","BT","AI-G",3e-05,0,0,0,0,0
"59","BT","AI-G",4e-05,0,0,0,0,0
"60","BT","AI-G",5e-05,0,0,0,0,0
"61","BT","AI-G",6e-05,0,0,0,0,0
"62","BT","AI-G",7e-05,0,0,0,0,0
"63","BT","AI-G",8e-05,0,0,0,0,0
"64","BT","AI-G",9e-05,0,0,0,0,0
"65","BT","AI-G",1e-04,0,0,0,0,0
"66","BT","AI-G",2e-04,0,0,0,0,0
"67","BT","AI-G",3e-04,0,0,0,0,0
"68","BT","AI-G",4e-04,0,0,0,0,0
"69","BT","AI-G",5e-04,0,0,0,0,0
"70","BT","AI-G",6e-04,0,0,0,0,0
"71","BT","AI-G",7e-04,0,0,0,0,0
"72","BT","AI-G",8e-04,0,0,0,0,0
"73","BT","AI-G",9e-04,0,0,0,0,0
"74","BT","AI-G",0.001,0,0,0,0,0
"75","BT","AI-G",0.002,0,0,0,0,0
"76","BT","AI-G",0.003,0,0,0,0,0
"77","BT","AI-G",0.004,0,0,0,0,1
"78","BT","AI-G",0.005,0,0,0,0,1
"79","BT","AI-G",0.006,0,0,0,0,1
"80","BT","AI-G",0.007,0,0,0,0,1
"81","BT","AI-G",0.008,0,0,0,0,1
"82","BT","AI-G",0.009,0,0,0,0,2
"83","BT","AI-G",0.01,0,0,0,0,2
"84","BT","AI-G",0.02,0,0,0,0,2
"85","BT","AI-G",0.03,0,0,0,0,3
"86","BT","AI-G",0.04,0,0,0,0,5
"87","BT","AI-G",0.05,0,0,0,0,7
"88","BT","AI-G",0.06,0,0,0,0,10
"89","BT","AI-G",0.07,0,0,0,0,14
"90","BT","AI-G",0.08,0,0,0,0,14
"91","BT","AI-G",0.09,0,0,0,0,15
"92","BT","AI-G",0.1,0,0,0,0,18
"93","BT","MedI-G",1e-06,0,0,0,0,0
"94","BT","MedI-G",2e-06,0,0,0,0,0
"95","BT","MedI-G",3e-06,0,0,0,0,0
"96","BT","MedI-G",4e-06,0,0,0,0,0
"97","BT","MedI-G",5e-06,0,0,0,0,0
"98","BT","MedI-G",6e-06,0,0,0,0,0
"99","BT","MedI-G",7e-06,0,0,0,0,0
"100","BT","MedI-G",8e-06,0,0,0,0,0
"101","BT","MedI-G",9e-06,0,0,0,0,0
"102","BT","MedI-G",1e-05,0,0,0,0,0
"103","BT","MedI-G",2e-05,0,0,0,0,0
"104","BT","MedI-G",3e-05,0,0,0,0,0
"105","BT","MedI-G",4e-05,0,0,0,0,0
"106","BT","MedI-G",5e-05,0,0,0,0,0
"107","BT","MedI-G",6e-05,0,0,0,0,0
"108","BT","MedI-G",7e-05,0,0,0,0,0
"109","BT","MedI-G",8e-05,0,0,0,0,0
"110","BT","MedI-G",9e-05,0,0,0,0,0
"111","BT","MedI-G",1e-04,0,0,0,0,0
"112","BT","MedI-G",2e-04,0,0,0,0,0
"113","BT","MedI-G",3e-04,0,0,0,0,0
"114","BT","MedI-G",4e-04,0,0,0,0,0
"115","BT","MedI-G",5e-04,0,0,0,0,0
"116","BT","MedI-G",6e-04,0,0,0,0,0
"117","BT","MedI-G",7e-04,0,0,0,0,0
"118","BT","MedI-G",8e-04,0,0,0,0,0
"119","BT","MedI-G",9e-04,0,0,0,0,0
"120","BT","MedI-G",0.001,0,0,0,0,0
"121","BT","MedI-G",0.002,0,0,0,0,1
"122","BT","MedI-G",0.003,0,0,0,0,1
"123","BT","MedI-G",0.004,0,0,0,0,1
"124","BT","MedI-G",0.005,0,0,0,0,1
"130","BT","MedI-G",0.02,0,0,0,0,3
"131","BT","MedI-G",0.03,0,0,0,0,4
"132","BT","MedI-G",0.04,0,0,0,0,6
"133","BT","MedI-G",0.05,0,0,0,0,6
"134","BT","MedI-G",0.06,0,0,0,0,7
"135","BT","MedI-G",0.07,0,0,0,0,8
"136","BT","MedI-G",0.08,0,0,0,0,11
"137","BT","MedI-G",0.09,0,0,0,0,12
"138","BT","MedI-G",0.1,0,0,0,0,13
"139","BT","TI-G",1e-06,0,0,0,0,0
"140","BT","TI-G",2e-06,0,0,0,0,0
"141","BT","TI-G",3e-06,0,0,0,0,0
"142","BT","TI-G",4e-06,0,0,0,0,0
"143","BT","TI-G",5e-06,0,0,0,0,0
"144","BT","TI-G",6e-06,0,0,0,0,0
"145","BT","TI-G",7e-06,0,0,0,0,0
"146","BT","TI-G",8e-06,0,0,0,0,0
"147","BT","TI-G",9e-06,0,0,0,0,0
"148","BT","TI-G",1e-05,0,0,0,0,0
"149","BT","TI-G",2e-05,0,0,0,0,0
"150","BT","TI-G",3e-05,0,0,0,0,0
"151","BT","TI-G",4e-05,0,0,0,0,0
"152","BT","TI-G",5e-05,0,0,0,0,0
"153","BT","TI-G",6e-05,0,0,0,0,0
"154","BT","TI-G",7e-05,0,0,0,0,0
"155","BT","TI-G",8e-05,0,0,0,0,0
"156","BT","TI-G",9e-05,0,0,0,0,0
"157","BT","TI-G",1e-04,0,0,0,0,0
"158","BT","TI-G",2e-04,0,0,0,0,0
"159","BT","TI-G",3e-04,0,0,0,0,0
"160","BT","TI-G",4e-04,0,0,0,0,0
"161","BT","TI-G",5e-04,0,0,0,0,0
"162","BT","TI-G",6e-04,0,0,0,0,0
"163","BT","TI-G",7e-04,0,0,0,0,0
"164","BT","TI-G",8e-04,0,0,0,0,0
"165","BT","TI-G",9e-04,0,0,0,0,0
"166","BT","TI-G",0.001,0,0,0,0,0
"167","BT","TI-G",0.002,0,0,0,0,0
"168","BT","TI-G",0.003,0,0,0,0,1
"169","BT","TI-G",0.004,0,0,0,0,1
"170","BT","TI-G",0.005,0,0,0,0,1
"171","BT","TI-G",0.006,0,0,0,0,1
"172","BT","TI-G",0.007,0,0,0,0,2
"173","BT","TI-G",0.008,0,0,0,0,2
"174","BT","TI-G",0.009,0,0,0,0,2
"175","BT","TI-G",0.01,0,0,0,0,2
"176","BT","TI-G",0.02,0,0,0,0,3
"177","BT","TI-G",0.03,0,0,0,0,4
"178","BT","TI-G",0.04,0,0,0,0,5
"179","BT","TI-G",0.05,0,0,0,0,5
"180","BT","TI-G",0.06,0,0,0,0,6
"181","BT","TI-G",0.07,0,0,0,0,9
"182","BT","TI-G",0.08,0,0,0,0,9
"183","BT","TI-G",0.09,0,0,0,0,13
"184","BT","TI-G",0.1,0,0,0,0,15
"185","BT","RLR-G",1e-06,0,0,0,0,91
"186","BT","RLR-G",2e-06,0,0,0,0,97
"187","BT","RLR-G",3e-06,0,0,0,0,101
"191","BT","RLR-G",7e-06,0,0,0,0,108
"192","BT","RLR-G",8e-06,0,0,0,0,109
"193","BT","RLR-G",9e-06,0,0,0,0,110
"194","BT","RLR-G",1e-05,0,0,0,0,110
"195","BT","RLR-G",2e-05,0,0,0,0,117
"196","BT","RLR-G",3e-05,0,0,0,0,121
"197","BT","RLR-G",4e-05,0,0,0,0,125
"198","BT","RLR-G",5e-05,0,0,0,0,128
"199","BT","RLR-G",6e-05,0,0,0,0,130
"200","BT","RLR-G",7e-05,0,0,0,0,133
"201","BT","RLR-G",8e-05,0,0,0,0,134
"202","BT","RLR-G",9e-05,0,0,0,0,134
"203","BT","RLR-G",1e-04,0,0,0,0,136
"204","BT","RLR-G",2e-04,0,0,0,0,144
"205","BT","RLR-G",3e-04,0,0,0,0,151
"206","BT","RLR-G",4e-04,0,0,0,0,158
"207","BT","RLR-G",5e-04,0,0,0,0,162
"208","BT","RLR-G",6e-04,0,0,0,0,165
"209","BT","RLR-G",7e-04,0,0,0,0,166
"210","BT","RLR-G",8e-04,0,0,0,0,168
"211","BT","RLR-G",9e-04,0,0,0,0,169
"212","BT","RLR-G",0.001,0,0,0,0,171
"213","BT","RLR-G",0.002,0,0,0,0,181
"214","BT","RLR-G",0.003,0,0,0,0,196
"215","BT","RLR-G",0.004,0,0,0,0,202
"216","BT","RLR-G",0.005,0,0,0,0,208
"217","BT","RLR-G",0.006,0,0,0,0,212
"218","BT","RLR-G",0.007,0,0,0,0,217
"219","BT","RLR-G",0.008,0,0,0,0,221
"220","BT","RLR-G",0.009,0,0,0,0,224
"221","BT","RLR-G",0.01,0,0,0,0,226
"222","BT","RLR-G",0.02,0,0,0,0,248
"223","BT","RLR-G",0.03,0,0,0,0,261
"224","BT","RLR-G",0.04,0,0,0,0,269
"225","BT","RLR-G",0.05,0,0,0,0,278
"226","BT","RLR-G",0.06,0,0,0,0,284
"227","BT","RLR-G",0.07,0,0,0,0,286
"228","BT","RLR-G",0.08,0,0,0,0,295
"229","BT","RLR-G",0.09,0,0,0,0,301
"230","BT","RLR-G",0.1,0,0,0,0,305
"231","BT","Loess-G",1e-06,0,0,0,0,53
"232","BT","Loess-G",2e-06,0,0,0,0,57
"233","BT","Loess-G",3e-06,0,0,0,0,58
"234","BT","Loess-G",4e-06,0,0,0,0,58
"235","BT","Loess-G",5e-06,0,0,0,0,63
"236","BT","Loess-G",6e-06,0,0,0,0,63
"237","BT","Loess-G",7e-06,0,0,0,0,63
"238","BT","Loess-G",8e-06,0,0,0,0,64
"239","BT","Loess-G",9e-06,0,0,0,0,64
"240","BT","Loess-G",1e-05,0,0,0,0,68
"241","BT","Loess-G",2e-05,0,0,0,0,75
"242","BT","Loess-G",3e-05,0,0,0,0,79
"243","BT","Loess-G",4e-05,0,0,0,0,79
"244","BT","Loess-G",5e-05,0,0,0,0,82
"245","BT","Loess-G",6e-05,0,0,0,0,86
"246","BT","Loess-G",7e-05,0,0,0,0,88
"247","BT","Loess-G",8e-05,0,0,0,0,89
"248","BT","Loess-G",9e-05,0,0,0,0,93
"249","BT","Loess-G",1e-04,0,0,0,0,95
"267","BT","Loess-G",0.01,0,0,0,0,167
"268","BT","Loess-G",0.02,0,0,0,0,186
"275","BT","Loess-G",0.09,0,0,0,0,253
"276","BT","Loess-G",0.1,0,0,0,0,255
"323","BT","Quantile",1e-06,0,0,0,0,75
"324","BT","Quantile",2e-06,0,0,0,0,86
"325","BT","Quantile",3e-06,0,0,0,0,90
"326","BT","Quantile",4e-06,0,0,0,0,93
"327","BT","Quantile",5e-06,0,0,0,0,98
"328","BT","Quantile",6e-06,0,0,0,0,98
"329","BT","Quantile",7e-06,0,0,0,0,98
"330","BT","Quantile",8e-06,0,0,0,0,100
"331","BT","Quantile",9e-06,0,0,0,0,100
"332","BT","Quantile",1e-05,0,0,0,0,100
"333","BT","Quantile",2e-05,0,0,0,0,103
"334","BT","Quantile",3e-05,0,0,0,0,105
"335","BT","Quantile",4e-05,0,0,0,0,111
"336","BT","Quantile",5e-05,0,0,0,0,112
"337","BT","Quantile",6e-05,0,0,0,0,113
"338","BT","Quantile",7e-05,0,0,0,0,116
"339","BT","Quantile",8e-05,0,0,0,0,117
"340","BT","Quantile",9e-05,0,0,0,0,118
"341","BT","Quantile",1e-04,0,0,0,0,118
"342","BT","Quantile",2e-04,0,0,0,0,124
"343","BT","Quantile",3e-04,0,0,0,0,131
"344","BT","Quantile",4e-04,0,0,0,0,137
"345","BT","Quantile",5e-04,0,0,0,0,141
"346","BT","Quantile",6e-04,0,0,0,0,142
"347","BT","Quantile",7e-04,0,0,0,0,143
"348","BT","Quantile",8e-04,0,0,0,0,146
"349","BT","Quantile",9e-04,0,0,0,0,147
"350","BT","Quantile",0.001,0,0,0,0,150
"353","BT","Quantile",0.004,0,0,0,0,178
"354","BT","Quantile",0.005,0,0,0,0,180
"355","BT","Quantile",0.006,0,0,0,0,183
"356","BT","Quantile",0.007,0,0,0,0,188
"357","BT","Quantile",0.008,0,0,0,0,194
"358","BT","Quantile",0.009,0,0,0,0,197
"359","BT","Quantile",0.01,0,0,0,0,197
"363","BT","Quantile",0.05,0,0,0,0,252
"366","BT","Quantile",0.08,0,0,0,0,278
"367","BT","Quantile",0.09,0,0,0,0,282
"368","BT","Quantile",0.1,0,0,0,0,289
"369","T","None",1e-06,0,0,0,0,0
"370","T","None",2e-06,0,0,0,0,0
"371","T","None",3e-06,0,0,0,0,0
"372","T","None",4e-06,0,0,0,0,0
"373","T","None",5e-06,0,0,0,0,0
"374","T","None",6e-06,0,0,0,0,0
"375","T","None",7e-06,0,0,0,0,0
"376","T","None",8e-06,0,0,0,0,0
"377","T","None",9e-06,0,0,0,0,0
"378","T","None",1e-05,0,0,0,0,0
"379","T","None",2e-05,0,0,0,0,0
"380","T","None",3e-05,0,0,0,0,0
"381","T","None",4e-05,0,0,0,0,0
"382","T","None",5e-05,0,0,0,0,0
"383","T","None",6e-05,0,0,0,0,0
"384","T","None",7e-05,0,0,0,0,0
"385","T","None",8e-05,0,0,0,0,0
"386","T","None",9e-05,0,0,0,0,0
"387","T","None",1e-04,0,0,0,0,0
"388","T","None",2e-04,0,0,0,0,0
"389","T","None",3e-04,0,0,0,0,0
"390","T","None",4e-04,0,0,0,0,0
"391","T","None",5e-04,0,0,0,0,0
"392","T","None",6e-04,0,0,0,0,0
"393","T","None",7e-04,0,0,0,0,0
"394","T","None",8e-04,0,0,0,0,0
"395","T","None",9e-04,0,0,0,0,0
"396","T","None",0.001,0,0,0,0,0
"397","T","None",0.002,0,0,0,0,0
"398","T","None",0.003,0,0,0,0,0
"399","T","None",0.004,0,0,0,0,0
"400","T","None",0.005,0,0,0,0,0
"401","T","None",0.006,0,0,0,0,0
"402","T","None",0.007,0,0,0,0,0
"403","T","None",0.008,0,0,0,0,0
"404","T","None",0.009,0,0,0,0,0
"405","T","None",0.01,0,0,0,0,0
"406","T","None",0.02,0,0,0,0,36
"407","T","None",0.03,0,0,0,0,46
"408","T","None",0.04,0,0,0,0,60
"409","T","None",0.05,0,0,0,0,73
"410","T","None",0.06,0,0,0,0,116
"411","T","None",0.07,0,0,0,0,127
"412","T","None",0.08,0,0,0,0,141
"413","T","None",0.09,0,0,0,0,159
"414","T","None",0.1,0,0,0,0,184
"415","T","AI-G",1e-06,0,0,0,0,0
"416","T","AI-G",2e-06,0,0,0,0,0
"417","T","AI-G",3e-06,0,0,0,0,0
"418","T","AI-G",4e-06,0,0,0,0,0
"419","T","AI-G",5e-06,0,0,0,0,0
"420","T","AI-G",6e-06,0,0,0,0,0
"421","T","AI-G",7e-06,0,0,0,0,0
"422","T","AI-G",8e-06,0,0,0,0,0
"423","T","AI-G",9e-06,0,0,0,0,0
"424","T","AI-G",1e-05,0,0,0,0,0
"425","T","AI-G",2e-05,0,0,0,0,0
"426","T","AI-G",3e-05,0,0,0,0,0
"427","T","AI-G",4e-05,0,0,0,0,0
"428","T","AI-G",5e-05,0,0,0,0,0
"429","T","AI-G",6e-05,0,0,0,0,0
"430","T","AI-G",7e-05,0,0,0,0,0
"431","T","AI-G",8e-05,0,0,0,0,0
"432","T","AI-G",9e-05,0,0,0,0,0
"433","T","AI-G",1e-04,0,0,0,0,0
"434","T","AI-G",2e-04,0,0,0,0,0
"435","T","AI-G",3e-04,0,0,0,0,0
"436","T","AI-G",4e-04,0,0,0,0,0
"437","T","AI-G",5e-04,0,0,0,0,0
"438","T","AI-G",6e-04,0,0,0,0,0
"439","T","AI-G",7e-04,0,0,0,0,0
"440","T","AI-G",8e-04,0,0,0,0,0
"441","T","AI-G",9e-04,0,0,0,0,0
"442","T","AI-G",0.001,0,0,0,0,0
"443","T","AI-G",0.002,0,0,0,0,0
"444","T","AI-G",0.003,0,0,0,0,0
"445","T","AI-G",0.004,0,0,0,0,0
"446","T","AI-G",0.005,0,0,0,0,0
"447","T","AI-G",0.006,0,0,0,0,0
"448","T","AI-G",0.007,0,0,0,0,0
"449","T","AI-G",0.008,0,0,0,0,0
"450","T","AI-G",0.009,0,0,0,0,0
"451","T","AI-G",0.01,0,0,0,0,0
"452","T","AI-G",0.02,0,0,0,0,0
"453","T","AI-G",0.03,0,0,0,0,0
"454","T","AI-G",0.04,0,0,0,0,17
"455","T","AI-G",0.05,0,0,0,0,19
"456","T","AI-G",0.06,0,0,0,0,22
"457","T","AI-G",0.07,0,0,0,0,35
"458","T","AI-G",0.08,0,0,0,0,51
"459","T","AI-G",0.09,0,0,0,0,69
"460","T","AI-G",0.1,0,0,0,0,84
"461","T","MedI-G",1e-06,0,0,0,0,0
"462","T","MedI-G",2e-06,0,0,0,0,0
"463","T","MedI-G",3e-06,0,0,0,0,0
"464","T","MedI-G",4e-06,0,0,0,0,0
"465","T","MedI-G",5e-06,0,0,0,0,0
"466","T","MedI-G",6e-06,0,0,0,0,0
"467","T","MedI-G",7e-06,0,0,0,0,0
"468","T","MedI-G",8e-06,0,0,0,0,0
"469","T","MedI-G",9e-06,0,0,0,0,0
"470","T","MedI-G",1e-05,0,0,0,0,0
"471","T","MedI-G",2e-05,0,0,0,0,0
"472","T","MedI-G",3e-05,0,0,0,0,0
"473","T","MedI-G",4e-05,0,0,0,0,0
"474","T","MedI-G",5e-05,0,0,0,0,0
"475","T","MedI-G",6e-05,0,0,0,0,0
"476","T","MedI-G",7e-05,0,0,0,0,0
"477","T","MedI-G",8e-05,0,0,0,0,0
"478","T","MedI-G",9e-05,0,0,0,0,0
"479","T","MedI-G",1e-04,0,0,0,0,0
"480","T","MedI-G",2e-04,0,0,0,0,0
"481","T","MedI-G",3e-04,0,0,0,0,0
"482","T","MedI-G",4e-04,0,0,0,0,0
"483","T","MedI-G",5e-04,0,0,0,0,0
"484","T","MedI-G",6e-04,0,0,0,0,0
"485","T","MedI-G",7e-04,0,0,0,0,0
"486","T","MedI-G",8e-04,0,0,0,0,0
"487","T","MedI-G",9e-04,0,0,0,0,0
"488","T","MedI-G",0.001,0,0,0,0,0
"489","T","MedI-G",0.002,0,0,0,0,0
"490","T","MedI-G",0.003,0,0,0,0,0
"491","T","MedI-G",0.004,0,0,0,0,0
"492","T","MedI-G",0.005,0,0,0,0,0
"493","T","MedI-G",0.006,0,0,0,0,0
"494","T","MedI-G",0.007,0,0,0,0,0
"495","T","MedI-G",0.008,0,0,0,0,0
"496","T","MedI-G",0.009,0,0,0,0,0
"497","T","MedI-G",0.01,0,0,0,0,0
"498","T","MedI-G",0.02,0,0,0,0,0
"499","T","MedI-G",0.03,0,0,0,0,0
"500","T","MedI-G",0.04,0,0,0,0,0
"501","T","MedI-G",0.05,0,0,0,0,0
"502","T","MedI-G",0.06,0,0,0,0,0
"503","T","MedI-G",0.07,0,0,0,0,30
"504","T","MedI-G",0.08,0,0,0,0,39
"505","T","MedI-G",0.09,0,0,0,0,45
"506","T","MedI-G",0.1,0,0,0,0,56
"507","T","TI-G",1e-06,0,0,0,0,0
"508","T","TI-G",2e-06,0,0,0,0,0
"509","T","TI-G",3e-06,0,0,0,0,0
"510","T","TI-G",4e-06,0,0,0,0,0
"511","T","TI-G",5e-06,0,0,0,0,0
"512","T","TI-G",6e-06,0,0,0,0,0
"513","T","TI-G",7e-06,0,0,0,0,0
"514","T","TI-G",8e-06,0,0,0,0,0
"515","T","TI-G",9e-06,0,0,0,0,0
"516","T","TI-G",1e-05,0,0,0,0,0
"517","T","TI-G",2e-05,0,0,0,0,0
"518","T","TI-G",3e-05,0,0,0,0,0
"519","T","TI-G",4e-05,0,0,0,0,0
"520","T","TI-G",5e-05,0,0,0,0,0
"521","T","TI-G",6e-05,0,0,0,0,0
"522","T","TI-G",7e-05,0,0,0,0,0
"523","T","TI-G",8e-05,0,0,0,0,0
"524","T","TI-G",9e-05,0,0,0,0,0
"525","T","TI-G",1e-04,0,0,0,0,0
"526","T","TI-G",2e-04,0,0,0,0,0
"527","T","TI-G",3e-04,0,0,0,0,0
"528","T","TI-G",4e-04,0,0,0,0,0
"529","T","TI-G",5e-04,0,0,0,0,0
"530","T","TI-G",6e-04,0,0,0,0,0
"531","T","TI-G",7e-04,0,0,0,0,0
"532","T","TI-G",8e-04,0,0,0,0,0
"533","T","TI-G",9e-04,0,0,0,0,0
"534","T","TI-G",0.001,0,0,0,0,0
"535","T","TI-G",0.002,0,0,0,0,0
"536","T","TI-G",0.003,0,0,0,0,0
"537","T","TI-G",0.004,0,0,0,0,0
"538","T","TI-G",0.005,0,0,0,0,0
"539","T","TI-G",0.006,0,0,0,0,0
"540","T","TI-G",0.007,0,0,0,0,0
"541","T","TI-G",0.008,0,0,0,0,0
"542","T","TI-G",0.009,0,0,0,0,0
"543","T","TI-G",0.01,0,0,0,0,0
"544","T","TI-G",0.02,0,0,0,0,0
"545","T","TI-G",0.03,0,0,0,0,0
"546","T","TI-G",0.04,0,0,0,0,17
"547","T","TI-G",0.05,0,0,0,0,19
"548","T","TI-G",0.06,0,0,0,0,22
"549","T","TI-G",0.07,0,0,0,0,35
"550","T","TI-G",0.08,0,0,0,0,51
"551","T","TI-G",0.09,0,0,0,0,69
"552","T","TI-G",0.1,0,0,0,0,84
"553","T","RLR-G",1e-06,0,0,0,0,0
"554","T","RLR-G",2e-06,0,0,0,0,0
"555","T","RLR-G",3e-06,0,0,0,0,0
"556","T","RLR-G",4e-06,0,0,0,0,0
"557","T","RLR-G",5e-06,0,0,0,0,0
"558","T","RLR-G",6e-06,0,0,0,0,0
"559","T","RLR-G",7e-06,0,0,0,0,0
"560","T","RLR-G",8e-06,0,0,0,0,0
"561","T","RLR-G",9e-06,0,0,0,0,0
"562","T","RLR-G",1e-05,0,0,0,0,0
"563","T","RLR-G",2e-05,0,0,0,0,0
"564","T","RLR-G",3e-05,0,0,0,0,0
"565","T","RLR-G",4e-05,0,0,0,0,0
"566","T","RLR-G",5e-05,0,0,0,0,0
"567","T","RLR-G",6e-05,0,0,0,0,0
"568","T","RLR-G",7e-05,0,0,0,0,0
"569","T","RLR-G",8e-05,0,0,0,0,0
"570","T","RLR-G",9e-05,0,0,0,0,0
"571","T","RLR-G",1e-04,0,0,0,0,0
"572","T","RLR-G",2e-04,0,0,0,0,0
"573","T","RLR-G",3e-04,0,0,0,0,0
"574","T","RLR-G",4e-04,0,0,0,0,0
"575","T","RLR-G",5e-04,0,0,0,0,0
"576","T","RLR-G",6e-04,0,0,0,0,0
"577","T","RLR-G",7e-04,0,0,0,0,0
"578","T","RLR-G",8e-04,0,0,0,0,0
"579","T","RLR-G",9e-04,0,0,0,0,0
"580","T","RLR-G",0.001,0,0,0,0,0
"581","T","RLR-G",0.002,0,0,0,0,0
"582","T","RLR-G",0.003,0,0,0,0,0
"583","T","RLR-G",0.004,0,0,0,0,0
"584","T","RLR-G",0.005,0,0,0,0,0
"585","T","RLR-G",0.006,0,0,0,0,0
"586","T","RLR-G",0.007,0,0,0,0,0
"587","T","RLR-G",0.008,0,0,0,0,2
"588","T","RLR-G",0.009,0,0,0,0,2
"589","T","RLR-G",0.01,0,0,0,0,2
"590","T","RLR-G",0.02,0,0,0,0,2
"591","T","RLR-G",0.03,0,0,0,0,2
"592","T","RLR-G",0.04,0,0,0,0,33
"593","T","RLR-G",0.05,0,0,0,0,57
"594","T","RLR-G",0.06,0,0,0,0,82
"595","T","RLR-G",0.07,0,0,0,0,100
"596","T","RLR-G",0.08,0,0,0,0,118
"597","T","RLR-G",0.09,0,0,0,0,140
"598","T","RLR-G",0.1,0,0,0,0,148
"599","T","Loess-G",1e-06,0,0,0,0,0
"600","T","Loess-G",2e-06,0,0,0,0,0
"601","T","Loess-G",3e-06,0,0,0,0,0
"602","T","Loess-G",4e-06,0,0,0,0,0
"603","T","Loess-G",5e-06,0,0,0,0,0
"604","T","Loess-G",6e-06,0,0,0,0,0
"605","T","Loess-G",7e-06,0,0,0,0,0
"606","T","Loess-G",8e-06,0,0,0,0,0
"607","T","Loess-G",9e-06,0,0,0,0,0
"608","T","Loess-G",1e-05,0,0,0,0,0
"609","T","Loess-G",2e-05,0,0,0,0,0
"610","T","Loess-G",3e-05,0,0,0,0,0
"611","T","Loess-G",4e-05,0,0,0,0,0
"612","T","Loess-G",5e-05,0,0,0,0,0
"613","T","Loess-G",6e-05,0,0,0,0,0
"614","T","Loess-G",7e-05,0,0,0,0,0
"615","T","Loess-G",8e-05,0,0,0,0,0
"616","T","Loess-G",9e-05,0,0,0,0,0
"617","T","Loess-G",1e-04,0,0,0,0,0
"618","T","Loess-G",2e-04,0,0,0,0,0
"619","T","Loess-G",3e-04,0,0,0,0,0
"620","T","Loess-G",4e-04,0,0,0,0,0
"621","T","Loess-G",5e-04,0,0,0,0,0
"622","T","Loess-G",6e-04,0,0,0,0,0
"623","T","Loess-G",7e-04,0,0,0,0,0
"624","T","Loess-G",8e-04,0,0,0,0,0
"625","T","Loess-G",9e-04,0,0,0,0,0
"626","T","Loess-G",0.001,0,0,0,0,0
"627","T","Loess-G",0.002,0,0,0,0,0
"628","T","Loess-G",0.003,0,0,0,0,0
"629","T","Loess-G",0.004,0,0,0,0,0
"630","T","Loess-G",0.005,0,0,0,0,0
"631","T","Loess-G",0.006,0,0,0,0,0
"632","T","Loess-G",0.007,0,0,0,0,0
"633","T","Loess-G",0.008,0,0,0,0,0
"634","T","Loess-G",0.009,0,0,0,0,0
"635","T","Loess-G",0.01,0,0,0,0,0
"636","T","Loess-G",0.02,0,0,0,0,1
"637","T","Loess-G",0.03,0,0,0,0,1
"638","T","Loess-G",0.04,0,0,0,0,35
"639","T","Loess-G",0.05,0,0,0,0,58
"640","T","Loess-G",0.06,0,0,0,0,79
"641","T","Loess-G",0.07,0,0,0,0,87
"642","T","Loess-G",0.08,0,0,0,0,106
"643","T","Loess-G",0.09,0,0,0,0,123
"644","T","Loess-G",0.1,0,0,0,0,131
"645","T","VSN-G",1e-06,0,0,0,0,0
"646","T","VSN-G",2e-06,0,0,0,0,0
"647","T","VSN-G",3e-06,0,0,0,0,0
"648","T","VSN-G",4e-06,0,0,0,0,0
"649","T","VSN-G",5e-06,0,0,0,0,0
"650","T","VSN-G",6e-06,0,0,0,0,0
"651","T","VSN-G",7e-06,0,0,0,0,0
"652","T","VSN-G",8e-06,0,0,0,0,0
"653","T","VSN-G",9e-06,0,0,0,0,0
"654","T","VSN-G",1e-05,0,0,0,0,0
"655","T","VSN-G",2e-05,0,0,0,0,0
"656","T","VSN-G",3e-05,0,0,0,0,0
"657","T","VSN-G",4e-05,0,0,0,0,0
"658","T","VSN-G",5e-05,0,0,0,0,0
"659","T","VSN-G",6e-05,0,0,0,0,0
"660","T","VSN-G",7e-05,0,0,0,0,0
"661","T","VSN-G",8e-05,0,0,0,0,0
"662","T","VSN-G",9e-05,0,0,0,0,0
"663","T","VSN-G",1e-04,0,0,0,0,0
"664","T","VSN-G",2e-04,0,0,0,0,0
"665","T","VSN-G",3e-04,0,0,0,0,0
"666","T","VSN-G",4e-04,0,0,0,0,0
"667","T","VSN-G",5e-04,0,0,0,0,0
"668","T","VSN-G",6e-04,0,0,0,0,0
"669","T","VSN-G",7e-04,0,0,0,0,0
"670","T","VSN-G",8e-04,0,0,0,0,0
"671","T","VSN-G",9e-04,0,0,0,0,0
"672","T","VSN-G",0.001,0,0,0,0,0
"673","T","VSN-G",0.002,0,0,0,0,0
"674","T","VSN-G",0.003,0,0,0,0,0
"675","T","VSN-G",0.004,0,0,0,0,0
"676","T","VSN-G",0.005,0,0,0,0,0
"677","T","VSN-G",0.006,0,0,0,0,0
"678","T","VSN-G",0.007,0,0,0,0,0
"679","T","VSN-G",0.008,0,0,0,0,0
"680","T","VSN-G",0.009,0,0,0,0,0
"681","T","VSN-G",0.01,0,0,0,0,0
"682","T","VSN-G",0.02,0,0,0,0,0
"683","T","VSN-G",0.03,0,0,0,0,1
"684","T","VSN-G",0.04,0,0,0,0,48
"685","T","VSN-G",0.05,0,0,0,0,75
"686","T","VSN-G",0.06,0,0,0,0,101
"687","T","VSN-G",0.07,0,0,0,0,116
"688","T","VSN-G",0.08,0,0,0,0,130
"689","T","VSN-G",0.09,0,0,0,0,151
"690","T","VSN-G",0.1,0,0,0,0,160
"691","T","Quantile",1e-06,0,0,0,0,2
"692","T","Quantile",2e-06,0,0,0,0,2
"693","T","Quantile",3e-06,0,0,0,0,2
"694","T","Quantile",4e-06,0,0,0,0,2
"695","T","Quantile",5e-06,0,0,0,0,2
"696","T","Quantile",6e-06,0,0,0,0,2
"697","T","Quantile",7e-06,0,0,0,0,2
"698","T","Quantile",8e-06,0,0,0,0,2
"699","T","Quantile",9e-06,0,0,0,0,2
"700","T","Quantile",1e-05,0,0,0,0,2
"701","T","Quantile",2e-05,0,0,0,0,2
"702","T","Quantile",3e-05,0,0,0,0,2
"703","T","Quantile",4e-05,0,0,0,0,2
"704","T","Quantile",5e-05,0,0,0,0,2
"705","T","Quantile",6e-05,0,0,0,0,2
"706","T","Quantile",7e-05,0,0,0,0,2
"707","T","Quantile",8e-05,0,0,0,0,2
"708","T","Quantile",9e-05,0,0,0,0,2
"709","T","Quantile",1e-04,0,0,0,0,2
"710","T","Quantile",2e-04,0,0,0,0,2
"711","T","Quantile",3e-04,0,0,0,0,2
"712","T","Quantile",4e-04,0,0,0,0,2
"713","T","Quantile",5e-04,0,0,0,0,2
"714","T","Quantile",6e-04,0,0,0,0,2
"715","T","Quantile",7e-04,0,0,0,0,2
"716","T","Quantile",8e-04,0,0,0,0,2
"717","T","Quantile",9e-04,0,0,0,0,2
"718","T","Quantile",0.001,0,0,0,0,2
"719","T","Quantile",0.002,0,0,0,0,2
"720","T","Quantile",0.003,0,0,0,0,2
"721","T","Quantile",0.004,0,0,0,0,2
"722","T","Quantile",0.005,0,0,0,0,2
"723","T","Quantile",0.006,0,0,0,0,2
"724","T","Quantile",0.007,0,0,0,0,2
"725","T","Quantile",0.008,0,0,0,0,2
"726","T","Quantile",0.009,0,0,0,0,2
"727","T","Quantile",0.01,0,0,0,0,2
"728","T","Quantile",0.02,0,0,0,0,4
"729","T","Quantile",0.03,0,0,0,0,9
"730","T","Quantile",0.04,0,0,0,0,15
"731","T","Quantile",0.05,0,0,0,0,55
"732","T","Quantile",0.06,0,0,0,0,77
"733","T","Quantile",0.07,0,0,0,0,83
"734","T","Quantile",0.08,0,0,0,0,93
"735","T","Quantile",0.09,0,0,0,0,117
"736","T","Quantile",0.1,0,0,0,0,142
